挨拶	あいさつ	名，サ変	打招呼；致词；寒暄、问候
間	あいだ	名	间隔、期间；中间
会う	あう	自五	会面、见面
合う	あう	自五，辅助	一致、符合；互相
遭う，遇う	あい	自五	遇到、遭遇
喘ぐ	あえぐ	自五	喘息、挣扎
青い	あおい	形	青色、蓝色、绿色；不成熟
仰ぐ	あおぐ	他五	仰视；尊敬；依靠、仰仗；一口气喝完
煽ぐ	あおぐ	他五	煽动
赤	あか	名	红色；完全
赤い	あかい	形	红色的；共产主义的
上がる	あがる	自五，辅助	上、登、升；提高、长进；（谦语）去；结束、完成；怯场；（敬语）吃、喝；（接动词连
明るい	あかるい	形	明亮的；开朗的、活泼的
秋	あき	名	秋天
明らか	あきらか	形動	明亮；明显、显然、确切
開く，明く	あく	自五	开
空く	あく	自五	有空隙；闲着；缺编
明ける	あける	他下一	天明；过年；期满、结束
空ける	あける	他下一	空出；腾出；不在家
挙げる	あげる	他下一	举；举起；举行；发动；扬（名）
上げる	あげる	他下一	举起、拎起；进房间；升学；进步、提高；增加数量、加深程度；得益；完成；显效；送给
揚げる	あげる	他下一	举起；油炸；起（货）
憧れる	あこがれる	自下一	向往、憧憬；被异性所吸引
朝	あさ	名	早上、上午
浅い	あさい	形	浅；（时间等）短；肤浅、少的；颜色浅
鮮やか	あざやか	形動	鲜明；出色
足	あし	名	脚、腿、（器物）的腿儿
味	あじ	名	味道、风味；滋味、甜头；趣味、情调
明日	あした	名	明天
味わう	あじわう	他五	品尝；玩味、欣赏；体验
預かる	あずかる	他五	收存、保管；照顾；承担、担任
預ける	あずける	他下一	寄存；托付、委托
焦る	あせる	自五	着急、焦躁
遊ぶ	あそぶ	自五	玩耍；旅行、游学；没工作；不起作用
与える	あたえる	他下一	授予；给予；使蒙受
暖かい，温かい	あたたかい	形	温暖；和睦；富足
頭	あたま	名	头
新しい	あたらしい	形	新的；新式的；新鲜的；有活力的；现代的，进步的
辺り	あたり	名	周围；大约；之类的
当たり前	あたりまえ	形動	当然；普通
当たる	あたる	自五	晒（太阳）、吹（风）等；顺利、成功；击中、命中、猜中；粗暴对待；承担、担任；被指
あちこち	あちこち	代	到处；顺序乱
あちら	あちら	代，名	那边；那个；那位
熱い	あつい	形	温度高；体温高；热烈的
暑い	あつい	形	气温高
厚い	あつい	形	有厚度；人情深厚；程度很深
篤い	あつい	形	病重；志笃、（感情）深厚
扱う	あつかう	他五	操作；对待、待遇；处理；出售；报道
あっさり	あっさり	副	清淡；轻易
集まる	あつまる	自五	集合、聚集；收集、集中
集める	あつめる	他下一	使集合；收集、征集；集中、吸引
圧力	あつりょく	名	压力；威压
宛て名	あてな	名	收信（件）人姓名和地址
当てる	あてる	他下一	碰撞；命中；晒；紧靠；中（奖）；猜对、预测正确；指名、委派
後	あと	名	后面；后方；以后；之后；那么、再见；（顺序）后；死后；后任、后继者、续弦；剩下的
後始末	あとしまつ	名，サ変	善后处理
穴，孔	あな	名	洞、穴；亏空
貴方	あなた	代	你、您
兄	あに	名	哥哥
姉	あね	名	姐姐；嫂子
あの	あの	連体	那个（远称）；那
暴く	あばく	他五	揭发；发掘
暴れる	あばれる	自下一	胡闹；闯荡
浴びせる	あびせる	他下一	浇、泼（水等）；使蒙受、使遭受；不断地质问、非难
浴びる	あびる	他上一	洗、淋浴、泼；沐浴；受到（非难、质问、赞扬等）
危ない	あぶない	形	危险的；垂危；不稳定、不确定；靠不住；危急、千钧一发
油，脂	あぶら	名	油；（人、动物身上的）脂肪
溢れる	あふれる	自下一	溢、满；形容人很多；充满、洋溢
阿呆	あほう	名，形動	蠢；傻子
甘い	あまい	形	甜；淡、咸味不足；指声音甜；不严格、宽松；考虑简单、浅薄、天真；男女间关系好；松
甘える	あまえる	自下一	撒娇；承蒙
余る	あまる	自五	剩、余；胜过
網	あみ	名	网；落网
編む	あむ	他五	编织；编纂
雨	あめ	名	雨、雨点般
怪しい	あやしい	形	奇怪的；可疑的、难以置信的；靠不住的、不确定的；要变坏的
怪しむ	あやしむ	他五	怀疑、觉得奇怪
操る	あやつる	他五	耍（木偶）；熟练的掌握、运用；驾驭、操纵
過ち	あやまち	名	失败、错；过失
誤る	あやまる	他五	错、弄错；耽误、贻误
謝る	あやまる	他五	认错
荒い	あらい	形	粗暴；剧烈；胡来
洗う	あらう	他五	洗；洗刷、冲洗；调查、查清
粗筋	あらすじ	名	梗概
争う	あらそう	他五	竞争；争吵、争论；主张、申辩
改まる	あらたまる	自五	更新；变好；郑重、客气
改める	あらためる	他下一	更新、改；改正；（语言、态度等）郑重；调查、计算
現す	あらわす	他五	使其出现；发挥
著す	あらわす	他五	撰写、著
表わす	あらわす	他五	表露；表现；意味着
現れる	あらわれる	自下一	显露；出现；来
有り難い	ありがたい	形	宝贵的；难得、感激
ありがとう	ありがとう	感	谢谢
在る	ある	自五	存在、活着；位于
或いは	あるいは	接	或者；用于列举同类事项；也许
歩く	あるく	自五	步行、外出
あれ	あれ	代名，感	那个；那件事；那时；那个人；那儿；哎呀
荒れる	あれる	自下一	海浪汹涌；荒废、荒芜；皮肤变粗糙、皴裂；（行为、秩序等）杂乱无章
泡	あわ	名	泡沫
淡い	あわい	形	颜色浅、味道淡；微少的
合わせる，併わせる	あわせる	他下一	合并；相加、合计；调整（机械、乐器）；适应；切合；核对；使一致、配合；混合
慌ただしい	あわただしい	形	不稳定的；慌忙、匆忙
慌てる	あわてる	自下一	着慌、慌忙
哀れ	あわれ	名	可怜、怜悯；情趣、情感
暗記	あんき	名，サ変	背诵
安心	あんしん	名，サ変，行動	安心、放心
安全	あんぜん	名，形動	安全
安定	あんてい	名，サ変	安定、稳定
案内	あんない	名，サ変	引导、通知；知道、了解
良い，好い	いい	形	好；合适；行、可以；最好、希望；容易
いい加減	いいかげん	名，副，形動	适度地；无根据、不负责任；很、相当
言う	いう	自，他五	说；有声响；询问；批评、评价；表达；叫、称做；议论、谣言；美言、讲情
家	いえ	名	房子；家；门第
家柄	いえがら	名	门第；家世
以下	いか	名	（数量、程度等）以下；下面
如何	いかが	副，形動	怎样、如何
生かす	いかす	他五	使活着；活用；使复活
息	いき	名	呼吸；步调
勢い	いきおい	名	力；活力、生气；劲头、情况；势力
息抜き	いきぬき	名，サ変	稍作休息、散心
生きる	いきる	自上一	谋生、维持生计；有效、有影响；生动、栩栩如生
行く	いく	自五	去；寄到；过去、逝去；往来、上班、上学；事情进展；以某种方式做
幾つ	いくつ	名	几个；几岁
幾ら	いくら	名	多少、多少钱；无论如何、即使也
池	いけ	名	池子、水池；砚池
いけない	いけない	形	不好的、不行的；没有希望的、没有指望的；禁止；（用なくてはいけない的形式表示）必
生ける	いける	他下一	插花；栽花
意見	いけん	名，サ変	想法；忠告、建议
以後	いご	名	以后
勇ましい	いさましい	形	勇敢的；大胆的；雄壮
石	いし	名	石头、石子；宝石
意地	いじ	名	气质、性情；固执、要强；物欲、食欲
維持	いじ	名，サ変	维持
医者	いしゃ	名	医生
以上	いじょう	名	上述；完、终；以上；既然
椅子	いす	名	椅子；职位
忙しい	いそがしい	形	忙碌
急ぐ	いそぐ	自他五	着急、赶紧；急、忙
痛い	いたい	形	疼痛；难受；（被触及弱点而）感到痛苦
抱く	いだく	他五	抱；怀有、抱有
致す	いたす	他五	“する”的谦恭说法；引起
頂く，戴く	いただく	他五	顶、戴、顶在上面；领受、蒙……赐给；“食う、飮む”的谦恭说法；请、给
痛む，傷む	いたむ	自五	（身体）疼痛；心痛、伤心；损坏
至る	いたる	自五	到、至；到（某时）；涉及到；结果为
位置	いち	名	位置；地位
一時	いちじ	名，副	同时；瞬时；那时、过去；暂时；1点钟
著しい	いちじるしい	形	显著的、明显的
一日	いちにち	名	一天；一整天；某日
一番	いちばん	名，副	第一；最；最好
一面	いちめん	名	事物的一个方面；一面、全面；报纸头版
何時	いつ	代	何时
一緒	いっしょ	名	一起做；同时发生；在一起
一杯	いっぱい	名，副	一杯、一碗；饮少量的酒；满满的；全部、沾满；极限；许多
一般	いっぱん	名	整个、普遍；普通、一般
一方	いっぽう	名，副助，接	一方面；（立场不同的双方中的）其中一方；一个劲儿地、一直；另一方面
いつも	いつも	副	经常地；平常
偽る	いつわる	他五	欺骗；说谎
糸	いと	名	线；乐器的弦；钓鱼线；线状物
従兄弟	いとこ	名	堂兄弟（姐妹）、表兄弟（姐妹）
以内	いない	接尾	以内
田舎	いなか	名	乡下、地方上的；故乡
犬	いぬ	名	狗；间谍、鹰犬
稲	いね	名	水稻
命	いのち	名	生命；寿命；最重要的
祈る	いのる	他五	（向神佛）祈祷；祝愿、希望
威張る	いばる	自五	趾高气扬、自吹自擂
今	いま	名，副	现在；当前；马上；正好、方才；用（今少しで）的形式，表示“几乎”
居間	いま	名	起居室
戒める	いましめる	他下一	训斥、警告；禁止
意味	いみ	名	意思；动机；含义；主旨、要点；意义
妹	いもうと	名	妹妹
嫌	いや	形動	令人厌烦
いよいよ	いよいよ	副	越发；终于；果真、确实
以来	いらい	名	那之后、以来；今后
いらいら	いらいら	副，サ変	情绪急躁、心理不安
いらっしゃる	いらっしゃる	自五	（敬语）来；（敬语）去；（敬语）在；相当于“……です”
入る	いる	自五	进入；达到某种状态
要る	いる	自五	需要、必要
居る	いる	自上一	（指人、动物等）有、在、居住在
入れる	いれる	他下一	装、放入；让入、让进；容纳；镶嵌；购进、输入；雇佣、采用；添、加；承认、容忍；加
色	いろ	名	色彩；肤色；表情；景象、样子；种类；恋爱、女色
色色	いろいろ	名，副，形動	各种各样
祝う	いわう	他五	庆祝；祝贺、贺礼
印象	いんしょう	名	印象
上	うえ	名	上面；表面；有关；还、而且；之后；既然……就；（接尾词）对长辈的敬称
植える	うえる	他下一	种、植；嵌入；打疫苗
伺う	うかがう	他五	打听；听说；访问
浮かぶ	うかぶ	自五	浮上水面、在空中飘；浮现、显露；想起
浮く	うく	自五	浮、飘、现；结余、剩余；高兴
受け入れる	うけいれる	他下一	接收；采纳；接纳
受け付ける	うけつける	他下一	受理；接收、采纳；对（药品、食物等）吸收
受け取る	うけとる	他五	接、收、领；理解
受ける	うける	自，他下一	获得；接住、挡住；接收（邀请、要求）；接收；上课、接收考试；遭到；相应、接受；继
動かす	うごかす	他五	使活动、开动、移动；变更；使感动、施加影响；使行动；影响
動く	うごく	自五	动、晃动；转动、开动；摇晃；活动；（受到影响）行动；变更；变动
牛	うし	名	牛
失う	うしなう	他五	失去、丧失；错过；丧、亡
後ろ	うしろ	名	后面；后背
薄い	うすい	形	薄的；色、味淡；（浓度、密度）低；程度低、缺乏
嘘	うそ	名	谎言；错误；不合适、不合时宜
歌う	うたう	他五	唱、唱歌；做诗（歌）；鸟儿鸣唱
疑う	うたがう	他五	猜疑；担心、怀疑；嫌疑
疑わしい	うたがわしい	形	可疑
家	うち	名	房屋；自己的家（庭）
内	うち	名	里面、内；内心；自己所在的组织或团体；在一定的范围、区域之内；（时间）以内；处于
打ち合わせる	うちあわせる	他下一	使相碰、互击；商量
打つ	うつ	自他五	打、敲响；敲打；击（球）；击（键盘）；注射；撒；（围棋等）下子；令人感动、打动
うっかり	うっかり	副，サ変	迷糊、心不在焉；疏忽
美しい	うつくしい	形	美好的、优美的；高尚的
移す	うつす	他五	移动；调动工作、转校；转移（注意力）；移交；改变状态；传染
写す，映す	うつす	他五	誊写、抄写；拍照；描写
訴える	うったえる	他下一	控告、诉讼；主张；诉诸于……；感动、打动
移る	うつる	自五	迁移、搬动；（地位等）发生变化；变迁；（话题、兴趣发生）变化；传染；熏上、染上
写る，映る	うつる	自五	映、照；被拍摄；照相
促す	うながす	他五	催促、敦促；促进、劝说
奪う	うばう	他五	抢夺；强烈吸引、迷人
馬	うま	名	马
旨い	うまい	形	美味的；高明、擅长；方便、顺利
生まれる	うまれる	自下一	出生、诞生；产生、出现
海	うみ	名	海
生む，産む	うむ	他五	生、产；产生、产出
埋める	うめる	他下一	埋入；填满；满满的；填补；（往热水里）兑凉水
裏	うら	名	里面；反面、背面；货币的背面；衣服等的里子；鞋底；后面；内幕；幕后
裏切る	うらぎる	他五	不守信条、背叛；辜负、与期待相反
恨む	うらむ	他五	怨恨、抱怨
羨ましい	うらやましい	形	羡慕
売る	うる	他五	卖、出售；沽名、扬名、出卖、背叛；找碴、挑起
潤う	うるおう	自五	湿润；受益、受惠
煩い，五月蠅い	うるさい	形	吵闹；讨厌、烦人；纠缠不休；议论纷纷
嬉しい	うれしい	形	高兴、快活
うろうろ	うろうろ	副，サ変	徘徊、彷徨；心神不安、不知所措
噂	うわさ	名	闲谈、传言、风言风语
運転	うんてん	名，サ変	驾驶；操纵、运转；周转
運動	うんどう	名，サ変	运动
運命	うんめい	名	命运
絵	え	名	绘画，画面
映画	えいが	名	电影
影響	えいきょう	名，サ変	影响
営業	えいぎょう	名，サ変	营业
英語	えいご	名	英语
描く	えがく	他五	画、描绘；造型；表现；想象
駅	えき	名	车站
閲覧	えつらん	名，サ変	阅览
偉い	えらい	形	杰出、卓越；地位（身份）高；（出乎意料地）严重、厉害
選ぶ	えらぶ	他五	挑选；看中；选拔；选举
得る	える	他下一	（通过努力、手段等）得到；能、可能
円	えん	名	圆形；日元
演じる	えんじる	他上一	上演、演出；做出（坏事等）、扮演
延長	えんちょう	名，サ変	延长；延长时间；全长；延长线
遠慮	えんりょ	名，自サ	远虑；礼让、谦虚；客气；谢绝
美味しい	おいしい	形	味美、好吃；有魅力
追う	おう	他五	追赶犯人、猎物等；驱赶；轰走；驱逐、清除；追求；按照顺序、随着时间
負う	おう	他五	背负；接受、担任责任；多亏、借助于；受伤
応援	おうえん	名，サ変	支持；声源、从旁助威
応接	おうせつ	名，サ変	接待
応募	おうぼ	名，サ変	应聘、应征
応用	おうよう	名，サ変	应用
多い	おおい	形	数量多；次数多、程度深
覆う	おおう	他五	蒙上、盖上；充满；包藏、掩饰；笼罩
大きい	おおきい	形	大的、个子高的；数目大；音量大；年长的；成长、长大；（规模等）大；夸大、夸张；显
大きな	おおきな	連体	大的
大勢	おおぜい	名	人数多
可笑しい	おかしい	形	可笑的、滑稽的；不正常；可疑的
侵す	おかす	他五	侵犯（国土、领域等）
犯す	おかす	他五	犯法、违反道德；强奸、施暴
冒す	おかす	他五	冒着危险、不顾困难；加害、带来伤害；亵渎
補う	おぎなう	他五	弥补
起きる	おきる	自上一	起床；不睡；离开病床；起身、站起来；发生、产生
奥	おく	名	里头、深处；后面；里屋、内宅、上房；胸中
億	おく	名	亿
置く	おく	自他五	摆、置；放置；放下、留下、丢下；购入以备出售；设置；任命、雇用；留在家住；寄存、
送る	おくる	他五	邮寄；派遣；送人、送行；吊唁、送别（死者）；渡过；依此传递、移动；送；标上假名
贈る	おくる	他五	赠送；授予（称号等）；报以、致以
遅れる	おくれる	自下一	迟到、赶不上；比预定晚；钟、表慢了
起こす，興す	おこす	他五	扶起；叫醒；翻起、弄起；开始；发动；生病；（思想、感情等）引起、惹起；发热、发电
行う	おこなう	他五	做、办；实施、举行
起る	おこる	自五	发生、产生；起因；兴起、起源；发热、发电；发病
怒る	おこる	自五	生气；训斥、呵斥
押さえる	おさえる	他下一	压、按、捂；堵；抓住
抑える	おさえる	他下一	抑制；压倒、凌驾；抑制感情；降低程度
幼い	おさない	形	幼小的；幼稚的
治まる	おさまる	自五	变得安定；止痛；心情平静
収まる	おさまる	自五	收纳、整齐地收好；解决、平息
納まる	おさまる	自五	缴纳；稳坐……的交椅；心满意足
修まる	おさまる	自五	端正
治める	おさめる	他下一	平定；统治、治理
収める	おさめる	他下一	收录；获得
納める	おさめる	他下一	接受；缴纳；结束
修める	おさめる	他下一	掌握学问；修、修养
惜しい	おしい	形	珍惜、可贵；可惜、委屈；遗憾
お爺さん	おじいさん	名	爷爷、祖父、外祖父
教える	おしえる	他下一	教、传授；告诉、指点
惜しむ	おしむ	他五	珍惜；认为可惜、吝啬；惋惜
おしゃべり	おしゃべり	形動，名，サ変	闲聊、聊天；多嘴多舌、健谈（的人）；议论、传言、风言风语
押す，推す，捺す	おす	他五	推、挤；压、碰；盖章；强行；压倒；顶住、不顾
お世辞	おせじ	名	恭维（话）、奉承（话）
汚染	おせん	名	污染
遅い	おそい	形	速度慢、迟缓；夜深；时间晚、迟
襲う	おそう	他五	袭击、侵袭；继承
恐れ入る	おそれいる	自五	不好意思；折服、佩服
恐れる	おそれる	自下一	害怕、畏惧；担心；敬畏
恐ろしい	おそろしい	形	可怕的；惊人的、非常的
教わる	おそわる	他五	收教、跟……学习
穏やか	おだやか	形動	平静、平稳；温和、安详
陥る	おちいる	自五	落入、掉进；陷入（不良）状态；中计
落ち着く	おちつく	自五	镇静、平心静气；稳定、安定；坐得稳；有头绪、有结果；（颜色、衣服等）淡雅
お茶	おちゃ	名	茶
落ちる	おちる	自上一	落下；崩溃、陷没；下、降；西沉、下山；脱落、褪色；漏掉；钱被用掉；落榜、落选；程
おっしゃる	おっしゃる	他五	说、称呼（敬语）
夫	おっと	名	丈夫
音	おと	名	（物体发出的）声响
弟	おとうと	名	弟弟
男	おとこ	名	男性、男子汉、大丈夫气质
陥れる	おとしいれる	他下一	使……陷入；陷害
落とす	おとす	他五	投下、扔下；弄掉、除掉；丢失、遗漏；减弱、降低；是陷入不好的状态；花钱；使落第；
訪れる	おとずれる	自下一	拜访；到来
一昨日	おととい	名	前天
一昨年	おととし	名	前年
大人	おとな	名	成人
大人しい	おとなしい	形	老实、温顺；（颜色）等素气
踊る	おどる	自五	跳舞；被操纵
驚く	おどろく	自五	惊讶、惊叹；吃惊、惊惶
同じ	おなじ	連体，形動	（性质、种类等）相同；一样的；相等；（用“同じ……なる”的形式表示）反正
鬼	おに	名	鬼怪；穷凶极恶的人
覚える	おぼえる	他下一	记忆；学习、掌握；感觉、感到
重い	おもい	形	重的；沉重的；重要的；（情况、程度等）重大的
思い出	おもいで	名	追忆、怀念
思う	おもう	他五	考虑；怀疑；推测；想象；感觉；期望；牵挂；爱慕；退出
面白い	おもしろい	形	有趣的；可笑的；（用否定的形式表示）情况不妙
玩具	おもちゃ	名	玩具；玩物
表	おもて	名	正面；家的正面；户外；棒球比赛的前半场；表面
親	おや	名	父母
泳ぐ	およぐ	自五	游泳；踉跄；栽倒；穿过；处世
及ぶ	およぶ	自五	达到；发展成；临到；匹敌；比得上；（用否定的形式表示）不需要、不必
降りる	おりる	自上一	（从交通工具中）下来；退位；半道退出；降霜等
下りる	おりる	自上一	降下；批准、发下来上锁
折る	おる	他五	折；折断；弯曲
降ろす	おろす	他五	让人下来；卸下；降旗；退位
下ろす	おろす	他五	放下、取下；风从高处刮下；落（发）；上锁；切鱼肉；擦丝；使用新产品；取出；打胎
終わる	おわる	自他五	完
音楽	おんがく	名	音乐
温度	おんど	名	温度
女	おんな	名	女性；情妇；女佣人
海外	かいがい	名	海外、外国
会議	かいぎ	名	会议
会計	かいけい	名	会计；付款、结帐
解決	かいけつ	名，サ変	解决
会合	かいごう	名，サ変	集合、集会、聚集
外交	がいこう	名	外交；推销
外向	がいこう	名	外向
外国	がいこく	名	外国
解散	かいさん	名，サ変	解决；组织解体；国会解散
開始	かいし	名，サ変	开始
会社	かいしゃ	名	公司
階段	かいだん	名	楼梯
解答	かいとう	名，サ変	解答
買い物	かいもの	名	买东西、买的东西；买得合算的东西
会話	かいわ	名，サ変	会话
買う	かう	他五	买；招、招致；惹起；主动承担；高度评价、赏识
返す	かえす	他五	归还；回报、回敬；报仇；回礼
かえって	かえって	副	反而；反倒
顧みる，省みる	かえりみる	他上一	回头看；回顾；反省；牵挂
返る	かえる	自五	复原；复归
帰る	かえる	自五	回来（去）；归去；（否定形式）死
代える	かえる	他下一	代替
換える	かえる	他下一	交换
替える	かえる	他下一	替换
変える	かえる	他下一	改变；移到别的地方
顔	かお	名	脸、表情
香る，薫る	かおる	自五	飘香
抱える	かかえる	他下一	用手抱；有麻烦事；雇
科学	かがく	名	科学
掲げる	かかげる	他下一	高举；登载；提出方针等
鏡	かがみ	名	镜子
掛かる	かかる	自五	悬、垂、吊；放在火上；降临、落到（身上）；锁着；放在上面；挂住、陷入；设置；靠着
拘わらず	かかわらず	連	尽管；不问、不管
関る	かかわる	自五	有关；拘泥
鍵	かぎ	名	钥匙；线索、关键
限る	かぎる	他五	限制、限于；最好；（否定的形式）不一定；未必
書く	かく	他五	写、画；写文章
隠す	かくす	他五	掩盖；隐藏、隐瞒
学生	がくせい	名	学生
学費	がくひ	名	学费
学歴	がくれき	名	学历
隠れる	かくれる	自下一	隐藏；躲藏；隐遁；作为借口
影	かげ	名	光；月光；倒影、影像；踪影、行踪；暗面
欠ける	かける	自下一	缺损；月蚀、日食；欠缺
掛ける	かける	他下一	垂下、悬、挂；放置火上；覆盖；洒；锁上、扣上；轻轻握住、搭着等；钩、钓；捆（箱子
加減	かげん	名，サ変	加法和减法；调节；事物的状态；健康状态；稍微
過去	かこ	名	过去；（人的）经历
囲む	かこむ	他五	围绕、环绕；包围
傘	かさ	名	伞
重ねる	かさねる	他下一	摞起、使重叠；反复、累积
飾る	かざる	他五	装饰；陈列；登载；修饰文章
菓子	かし	名	点心、糖果
貸す	かす	他五	借款、贷款；出租；帮助、出力
数	かず	名	数目、数
風	かぜ	名	风；架子、派头
風邪	かぜ	名	感冒
稼ぐ	かせぐ	自他五	做工赚钱；努力争取
数える	かぞえる	他下一	数数；列举
家族	かぞく	名	家族
肩	かた	名	肩膀；衣服的肩膀；器物的上方
固い	かたい	形	坚硬的；紧的；坚定的；严重的；确实的；顽固的
硬い	かたい	形	坚硬的；僵、硬；生涩的、生硬的；表情僵硬
堅い	かたい	形	坚实的；可以信赖的；严肃的
片付ける	かたづける	他下一	收拾；解决；嫁出去；除去妨碍者
固まる	かたまる	自五	凝固；集中到一处；确实、可靠
傾く	かたむく	自五	倾斜；（日、月）西沉；衰落；带有某种倾向
固める	かためる	他下一	使坚固；坚守；坚定；安定、稳定；归拢到一起
勝つ	かつ	自五	得胜；胜过、超过
学科	がっか	名	学科
がっかり	がっかり	副，サ変	失望的样子；非常疲劳的样子
担ぐ	かつぐ	他五	担负；推举；骗人、捉弄人；迷信
学校	がっこう	名	学校
勝手	かって	名，形動	厨房；生活状况；情形；样子、状况；任性、随便
悲しい	かなしい	形	悲伤的、可悲的
悲しむ	かなしむ	他五	悲伤、悲痛
必ず	かならず	副	一定
金	かね	名	金属；金钱
鞄	かばん	名	包
壁	かべ	名	墙；障碍、障碍物
我慢	がまん	名，サ変	忍耐
神	かみ	名	神
紙	かみ	名	纸；划拳时的纸
髪	かみ	名	头发；发型
雷	かみなり	名	雷
噛む	かむ	他五	咬、嚼；齿轮咬合；简易地说；（水）猛烈冲击；有关系的
痒い	かゆい	形	痒
通う	かよう	自五	上班、走读；交通工具往来；通往；心意相通；相似、相通
辛い	からい	形	辣的；咸的；严格的；严酷的
体	からだ	名	身体；身体状况
借りる	かりる	他上一	借钱、东西等；借助
軽い	かるい	形	轻的；轻快的；轻微的；轻松的；清淡、少量；容易的；轻率的
彼	かれ	名，代	他；情人（丈夫）
枯れる	かれる	自下一	枯萎；技艺等造诣精深、成熟
川，河	かわ	名	河、河流
皮，革	かわ	名	皮、表皮、皮革
側	がわ	名	一侧、一方面
可愛い	かわいい	形	可爱的；讨人喜欢的；小巧的
可哀相	かわいそう	形動	可怜的
渇く	かわく	自五	渴
代わる	かわる	自五	代替、取代
変わる	かわる	自五	变化；变更、转移；区别；特殊
缶	かん	名	（金属）筒、罐、罐头
考える	かんがえる	他下一	思考；深思熟虑；考虑；反省；精神准备、早做准备；决心；预见；想象；设法
感覚	かんかく	名	感觉
環境	かんきょう	名	环境
関係	かんけい	名	关系、有关；性关系
歓迎	かんげい	名，サ変	欢迎
漢字	かんじ	名	汉字
元日	がんじつ	名	元旦
感謝	かんしゃ	名，サ変	感谢
感情	かんじょう	名	感情
勘定	かんじょう	名，サ変	计算；付账、结帐；考虑、估计
感じる	かんじる	自他上一	感觉；感动；感触
関心	かんしん	名	关心
感心	かんしん	名，形動，サ変	佩服；赞赏
完全	かんぜん	名，形動	完全
感想	かんそう	名	感想
簡単	かんたん	名，形動	简单；简短
感動	かんどう	名，サ変	感动
観念	かんねん	名，サ変	观念；意识；断念、不抱希望
乾杯	かんぱい	名，サ変	干杯
頑張る	がんばる	自五	努力、全力以赴；主张、固守不动
管理	かんり	名，サ変	管理
木	き	名	树、木材
気	き	名	空气；气氛；风味、味道；意志；心情；意识；（用“……する気”的形式表示）准备做；
黄色	きいろ	名	黄色
議員	ぎいん	名	议院
消える	きえる	自下一	火熄灭、光消失等；消失；雪融化；感情、记忆等消失
記憶	きおく	名，サ変	记忆
機会	きかい	名	机会
機械	きかい	名	机械
危機	きき	名	危机
利く	きく	自五	有效；敏锐
効く	きく	自五	有效
聞く，聴く	きく	他五	听；听说；听从；遂愿；问、询问；闻（味）、品（尝）
危険	きけん	名，形動	危险
機嫌	きげん	名	安泰；心情、情绪
気候	きこう	名	气候、气象
聞こえる	きこえる	自下一	听得见；听起来似乎是……；有名；理解、同意
記者	きしゃ	名	记者
汽車	きしゃ	名	火车
傷	きず	名	伤；瑕疵；有损于、缺点、污点
築く	きずく	他五	修筑、构筑；确立、确定
犠牲	ぎせい	名	牺牲
季節	きせつ	名	季节
基礎	きそ	名	基础
規則	きそく	名	规则
北	きた	名	北、北方、北面
気体	きたい	名	气体
期待	きたい	名，サ変	期待、期望
汚い	きたない	形	脏的、不干净的；卑劣；卑鄙的；吝啬的
きちんと	きちんと	副	干净、整洁地；正确地；如期地；恰当地、妥切地
きつい	きつい	形	严厉、苛刻的；强烈的；严厉；紧的、瘦小的
切手	きって	名	邮票
きっと	きっと	副	一定、毫无疑问地；严厉地、严肃地
切符	きっぷ	名	票、券
記念	きねん	名，サ変	纪念
昨日	きのう	名	昨天；不久以前、过去
機能	きのう	名，サ変	机能
気の毒	きのどく	名，形動	可怜的；对不起，抱歉
厳しい	きびしい	形	严格的；严酷的；厉害的；严峻的
希望	きぼう	名	希望
基本	きほん	名	基本
決まる	きまる	自五	决定；当然、必定
義務	ぎむ	名	义务
決める	きめる	他下一	决定；决心；定局；做好；以……为习惯
気持ち	きもち	名	感情；情绪；心境；感觉；一点点
着物	きもの	名	衣服；和服
客	きゃく	名	客人
休憩	きゅうけい	名，サ変	休息、歇
休日	きゅうじつ	名	休息日
給料	きゅうりょう	名	报酬、薪水
今日	きょう	名	今天
教育	きょういく	名	教育
教科書	きょうかしょ	名	教科书
行事	ぎょうじ	名	仪式；活动
兄弟	きょうだい	名	兄弟、姐妹；把兄弟、哥儿们
興味	きょうみ	名	兴趣
協力	きょうりょく	名，サ変	协作
許可	きょか	名，サ変	许可
去年	きょねん	名	去年
嫌い	きらい	形動，名	不喜欢；有点；（用否定式表示）不分
嫌う	きらう	自五	憎恶；敬而远之、回避；（用否定式表示）不论、不分
霧	きり	名	雾
切る	きる	他五	切、剪；被刀划受伤；解除关系；使中断；限于；减少、降低；去掉水份等；改变方向；开
着る	きる	他上一	穿；背负
綺麗	きれい	形動	美丽；干净；手脚麻利；没有污点；完全
切れる	きれる	自下一	被切断；锋利；断绝关系；中断；终结、完了；结束；低于；反应敏捷
記録	きろく	名，サ変	记录
銀行	ぎんこう	名	银行
禁止	きんし	名，サ変	禁止
禁じる	きんじる	他上一	禁止
具合	ぐあい	名	健康状态；事态、情况；做法；方便；合适
食う	くう	他五	生活；虫咬；紧逼对方；侵入对方的势力范围；打倒强手；费时、费钱；上年纪；遭到
空間	くうかん	名	空间
空気	くうき	名	大气；气氛
偶然	ぐうぜん	名，形動，副	偶然、偶尔
潜る	くぐる	自五	从下面穿过；趁不注意逃走
草	くさ	名，接頭	草、饲草；非正式
臭い	くさい	形	臭；可疑；造作、故意；有气味；派头、样子
腐る	くさる	自五	腐烂；金属受腐蚀；堕落；情绪低落
愚図愚図	ぐずぐず	副	慢手慢脚的样子；发牢骚的样子
崩す	くずす	他五	敲坏、折毁；使凌乱、散乱；换成零钱、破开；欢颜
薬	くすり	名	药、益处
崩れる	くずれる	自下一	崩溃、倒塌；紊乱；走形、凌乱；天气变坏；换成零钱；行情急剧下落
癖	くせ	名	癖性；特征；（头发）卷儿、（衣服）褶儿
下さい	ください	連	请给我……；请帮我……
下さる	くださる	他五	“与える”的尊敬语；“してくれる”的尊敬语
果物	くだもの	名	水果
下る	くだる	自五	往低处移动；低于；从中心地朝四周去；下（命令、判决等）；时代变迁；拉肚子；投降
口	くち	名	人或是动物的嘴；像嘴一样张开的部分；语言、说法；传闻；味觉；抚养的人数；（工作等
靴	くつ	名	鞋
国	くに	名	国家；地方；故乡
配る	くばる	他五	分配；配置；用心、注意
首	くび	名	颈部；生命；免职、解雇
組み立てる	くみたてる	他下一	组装
汲む	くむ	他五	舀起液体；摄取；体谅
組む	くむ	自他五	组装；交叉；成为朋友、合伙；对战
雲	くも	名	云；模糊
曇る	くもる	自五	天空多云；模糊；发愁
悔しい	くやしい	形	后悔；窝囊
位	くらい	副助	大致的数量；（带轻蔑的语气）至少；差不多
暗い	くらい	形	昏暗；颜色不明朗；心情沉重；不熟悉、生疏；不光彩的
暮らす	くらす	自五	生活；维持生活；度过时光
比べる，較べる	くらべる	自他下一	比较；比高低
来る	くる	力変	来；来访；季节、时间到来；送到；引进；来源于；起因；变成某种状态
苦しい	くるしい	形	痛苦；辛苦；艰难；困惑；勉强
苦しむ	くるしむ	自五	痛苦；烦恼；难于；费尽周折
車	くるま	名	车轮；汽车、马车
暮れる	くれる	自下一	天晚；季节过去；想不出、不知如何
呉れる	くれる	他下一	别人给自己；别人帮助自己做某事
黒	くろ	名	黑色；值得怀疑
黒い	くろい	形	黑的；脸色黑；被弄脏；阴暗；心地肮脏；有犯罪嫌疑；不吉祥的
苦労	くろう	名，サ変	费周折、担心
加える	くわえる	他下一	加算；增加；吸收为伙伴；给予
詳しい	くわしい	形	详细的；精通
加わる	くわわる	自五	增加；增多；加入
計画	けいかく	名，サ変	计划
景気	けいき	名	经济状况；活跃
経験	けいけん	名，サ変	经验
傾向	けいこう	名	倾向、趋势；性格、趋向
経済	けいざい	名	经济；节约
警察	けいさつ	名	警察
計算	けいさん	名，サ変	计算；计算、盘算、打算
形式	けいしき	名	样式、款式；形式上的、表面上的
芸術	げいじゅつ	名	艺术
怪我	けが	名，サ変	受伤；过失
消す	けす	他五	灭火；关（灯、煤气等）；删除；包盖、吸收；消灭；杀死
削る	けずる	他五	刀削；削减
結果	けっか	名	结果
結構	けっこう	名，形動	构造；非常好的、无懈可击的；足够的、满足的；不需要
結婚	けっこん	名，サ変	结婚
決して	けっして	副	（后接否定式）决不
決心	けっしん	名，サ変	决心、下决心
決断	けつだん	名，サ変	下定决心
決定	けってい	名，サ変	决定
結論	けつろん	名	结论
煙	けむり	名	烟；像烟似的
蹴る	ける	他五	用脚踢；不满地从座位上站起来；拒绝要求
けれども	けれども	接続，助	表示转折关系；没有特别的意义、仅仅表示前后话题的连接；作为终助词、用于表示谦虚地
険しい	けわしい	形	险峻的；可怕的、险恶的；有危险的、艰险的
権威	けんい	名	权威
原因	げんいん	名	原因
喧嘩	けんか	名，サ変	争吵；打假
見学	けんがく	名，サ変	实地参观
玄関	げんかん	名	大门
元気	げんき	名，形動	有活力；健康
現金	げんきん	名，形動	现金；贪图眼前利益、势力眼
言語	げんご	名	语言
健康	けんこう	名，形動	身体状况；健康
検査	けんさ	名，サ変	检查
現在	げんざい	名	现在；当时、截至某时
現象	げんしょう	名	现象
建設	けんせつ	名，サ変	建造；设立、创立
現代	げんだい	名	现代
建築	けんちく	名，サ変	建筑
権利	けんり	名	权利
原料	げんりょう	名	原料
鯉	こい	名	鲤鱼
濃い	こい	形	颜色深；深度、密度高；味道浓；关系深
語彙	ごい	名	词汇
行為	こうい	名	行为
公園	こうえん	名	公园
効果	こうか	名	效果
合格	ごうかく	名，サ変	合格
交換	こうかん	名，サ変	交换
工業	こうぎょう	名	工业
工事	こうじ	名，サ変	工事
構造	こうぞう	名	构造
交通	こうつう	名	交通；客货的输送
行動	こうどう	名，サ変	行动
被る	こうむる	他五	遭受损害、屈辱；得到恩惠；承蒙
交流	こうりゅう	名，サ変	交流
声	こえ	名	人或是动物所发出的声音；语言；意见；迹象
越える，超える	こえる	自下一	超过；超越；穿越
氷	こおり	名	冰
凍る	こおる	自五	结冰
故郷	こきょう	名	故乡
国語	こくご	名	国语、语文
国際	こくさい	名	国际
国民	こくみん	名	国名
此処	ここ	代	这里；最近；这时；目前的阶段、范围；这点
午後	ごご	名	午后、下午
心	こころ	名	精神；想法；心情、感觉；体贴心；真心；爱情；意义
志す	こころざす	他五	以……为目标、决心
試みる	こころみる	他上一	尝试、企图
腰	こし	名	腰；弹力、粘度
故障	こしょう	名，サ変	故障
個人	こじん	名	个人
越す	こす	他五	穿过、通过；度过时光；越过高峰；经过；追赶；搬家；来、去的敬语
答える	こたえる	他下一	回答；解答
拘る	こだわる	自五	讲究、在乎、固执
ご馳走	ごちそう	名，サ変	款待；佳肴
此方	こちら	代	这里；这个；自己
事	こと	名	事情；理由；工作；内容
今年	ことし	名	今年
異なる	ことなる	自五	不同；特别
言葉	ことば	名	语言；单词、语句、表达；说法、讲法；所说的话
子供	こども	名	自己的儿女；年幼者
断る	ことわる	他五	谢绝、拒绝；预先通知；道歉、解释
粉	こな	名	粉末
この	この	連体	这、这个；这件（事）
この頃	このごろ	名	最近
好む	このむ	他五	爱好、喜欢
拒む	こばむ	他五	拒绝、不承认；阻止
ご飯	ごはん	名	饭
ご無沙汰	ごぶさた	名，サ変	疏于问候、久违
零れる	こぼれる	自下一	漏、落、掉；溢出；露出
細かい	こまかい	形	细微；严密的、详细的；会打算、小气
誤魔化す	ごまかす	他五	骗人；撒谎；敷衍了事、蒙混过关；骗取
困る	こまる	自五	处于困境、倒霉；不知所措
込む	こむ	自五	拥挤；复杂、精雕细刻
米	こめ	名	稻米
御免	ごめん	名	原谅；拒绝；免职
籠（も）る	こもる	自五	隐居、隐藏；闭门不出；包含；烟等弥漫于某场所；声音不清楚
凝らす	こらす	他五	使凝固、使僵硬；使集中
凝る	こる	自五	肌肉变硬；热衷于；讲究、精心制作
此れ，是	これ	代，感	此、这；现在；这人（用于家人或下属）
頃	ころ	名	时期；时机
転がす	ころがす	他五	滚动；推倒；放置
転がる	ころがる	自五	滚动；倒下；横躺；随意搁置着
ごろごろ	ごろごろ	副，サ変	汽车、地震等声音；滚动的样子；随处可见；混入异物、沙子等；懒洋洋
殺す	ころす	他五	杀害；压抑；埋没
転ぶ	ころぶ	自五	跌倒；滚转
怖い	こわい	形	恐惧、恐怖、可怕、吓人
壊す	こわす	他五	破坏、损坏；损害、损伤；破坏、砸锅
声高	こわだか	形動	高声
強張る	こわばる	自五	生硬、变硬
壊れる	こわれる	自下一	乱七八糟、支离破碎；失败、流产；出故障
今月	こんげつ	名	本月、这个月
今後	こんご	名	今后、将来
今週	こんしゅう	名	本周、这一周
今度	こんど	名	这次、这回；最近、上次；下次
困難	こんなん	名，形動	困难、棘手
今日	こんにち	名	今天；当代、现代
今晩	こんばん	名	今晚、今夜
混乱	こんらん	名，サ変	混乱
最近	さいきん	名	最近
最後	さいご	名	最后；一旦……就
最高	さいこう	名，形動	最高的；最好的、最了不起的
財産	ざいさん	名	财产
最終	さいしゅう	名	最终
最低	さいてい	名	最低；砸锅、不行、糟糕
才能	さいのう	名	才能
財布	さいふ	名	钱包
材料	ざいりょう	名	原料；资料、题材；影响行情的原因
幸い	さいわい	名，形動，サ変	幸福、荣幸；合适、方便
坂	さか	名	斜坡；年龄、气势的高低
探す，捜す	さがす	他五	追踪；物色；寻找
魚	さかな	名	鱼
肴	さかな	名	下酒菜、佳肴；饮酒时的助兴
逆らう	さからう	自五	逆行；反抗
盛り	さかり	名	最盛时期；壮年、精力充沛的时期
下がる	さがる	自五	下降；向后移、向后退；推移、进展；（阶段、程度、数值等）变低
先	さき	名	尖端、末梢、前头；先、早；将来；以前；事前、事先；目的地；剩余、继续；对象、对方
作業	さぎょう	名，サ変	工作、作业
咲く	さく	自五	开花；说话投机
作文	さくぶん	名	作文
桜	さくら	名	樱花
探る	さぐる	他五	摸、找；调查；探访风景等
酒	さけ	名	酒
叫ぶ	さけぶ	自五	大声叫喊；主张
避ける	さける	他下一	避免、逃避；逃避责任；回避、避开；忌讳
下げる	さげる	他下一	降低；下垂、下挂；收拾、打烊；往后退；取钱；降低（阶段、程度、数值等）
支える	ささえる	他下一	支撑；抵挡、抵御；担负、维持
捧げる	ささげる	他下一	捧起；献给；奉献、牺牲
差し上げる	さしあげる	他下一	举起、抬起；（敬）给
指す	さす	他五	指给人看；叫名字、点名；朝着、以……为目标；下象棋
差す	さす	自他五	倒水；添加；擦、涂；举到头上；插、夹带；撑（船）；劝酒、敬酒；呈现出；涨潮
さすが	さすが	副	到底是、不愧是；但是、不过；就连……也
誘う	さそう	他五	邀请；相约；加快、催促；诱惑
雑誌	ざっし	名	杂志
砂糖	さとう	名	白砂糖
寂しい	さびしい	形	寂寞、悲哀；寂静；令人不满的、令人遗憾的
様	さま	名，代	敬称；表示敬意、客气的说法；样子、情景
妨げる	さまたげる	他下一	妨碍、阻止
寒い	さむい	形	寒冷；胆怯、心虚；简陋的
作用	さよう	名，サ変	作用、影响
さよなら	さよなら	感	再见
更に	さらに	副	进一步；更加；反复、再三；（下接否定形式）一点也
皿	さら	名，接尾	盘子；碟状物；（做数量词用）碟、盘
去る	さる	自他五	离去；时间流逝；死去；消失；相隔、相距；过去的；除去、消除；辞职；远离、疏远
騒ぐ	さわぐ	自五	大声叫喊；大肆喧哗；哗哗摆动；起哄、闹事；心里乱糟糟
触る	さわる	自五	轻轻地接触、触摸
さん	さん	接尾	用在人名、职务后表示尊敬
産業	さんぎょう	名	产业
賛成	さんせい	名，サ変	赞成
残念	ざんねん	形動	遗憾、可惜
散歩	さんぽ	名，サ変	散步
試合	しあい	名，サ変	比赛、竞争
幸せ	しあわせ	形動	幸福；幸运
塩	しお	名	食盐
萎れる	しおれる	自下一	（植物）枯萎、蔫；气馁、泄气
然し，併し	しかし	接続	但是
しかも	しかも	接続	而且；即使……也
時間	じかん	名	小时；时间、光阴；时刻
四季	しき	名	四季
刺激	しげき	名，サ変	刺激；鼓舞、鼓励；使兴奋
試験	しけん	名，サ変	考试；试验
事件	じけん	名	事件；（杀人、强盗等）案件
時刻	じこく	名	时刻
仕事	しごと	名	工作；职务、业务
事実	じじつ	名，副	事实；实际
辞書	じしょ	名	辞书、辞典
事情	じじょう	名	状态、理由
静か	しずか	形動	安静；平静、安稳；宁静
沈む	しずむ	自五	沉没；落山；变低；变得阴郁、忧郁；陷入、沦落
姿勢	しせい	名	姿势；态度、姿态
自然	しぜん	名，形動	大自然；自然、不做作；当然；自然而然
下	した	名	下部、下放；楼下；内侧；年纪小；（程度、地位等）低；刚……之后
舌	した	名	舌头；味觉
時代	じだい	名	时势；（历史上的）年代；人生的某一时期
従う	したがう	自五	服从；跟随；沿着；随着……
従って	したがって	接続	由于、因此
支度，仕度	したく	名，サ変	准备；装备；打扮、整装
親しい	したしい	形	亲密、关系好；熟悉
しっかり	しっかり	副，サ変	牢固地；结实；值得信赖的；清醒、不糊涂；认真、扎实；确实、的确；很多、足够
躾	しつけ	名	使……守规矩、管教、训练
実験	じっけん	名，サ変	实验、试验；实际经验
実行	じっこう	名，サ変	行动、付诸行动
実際	じっさい	名，副	实际；真正地
じっと	じっと	副，サ変	一动不动、安静地；专心致志地；耐心地
失敗	しっぱい	名，サ変	错误、失败
失礼	しつれい	形動，サ変	失礼、无礼；对不起、劳驾；失陪了
指導	しどう	名，サ変	指导
品物	しなもの	名	物品、商品
死ぬ	しぬ	自五	死亡；失去生气；闲置着、不起作用
暫く	しばらく	副	一会儿；暂时、目前；一段时间
渋い	しぶい	形	（味道）苦涩；（表情等）苦涩；古朴的、高雅的；小气的
自分	じぶん	名	自身、自己；我
絞る，搾る	しぼる	他五	挤、榨；扎起来；缩小；把声音调小；缩小范围；绞尽脑汁；严厉责备、批评
島	しま	名	岛屿
仕舞う	しまう	自他五	收拾、整理；保存；关门、倒闭
了う	しまう	補動	表示完了；表示不希望出现的结果
閉まる	しまる	自五	关门
締まる	しまる	自五	不宽松、紧
自慢	じまん	名，サ変	骄傲、自豪、豪言
事務	じむ	名	事务
示す	しめす	他五	出示；表达（心情等）；指点；（钟表等）显示刻度
閉める	しめる	他下一	关闭；倒闭
占める	しめる	他下一	占有；取得、获取
社会	しゃかい	名	社会；相同行业
写真	しゃしん	名	照片
喋る	しゃべる	他五	聊天、唠叨
邪魔	じゃま	名，サ変	障碍物、妨碍；拜访、串门
週	しゅう	名	周、星期
自由	じゆう	名，形動	自由、随便
習慣	しゅうかん	名	习惯；风习
宗教	しゅうきょう	名	宗教
収入	しゅうにゅう	名	所得；收益
十分	じゅうぶん	形動，副	许多；完全地
重要	じゅうよう	形動	重要
授業	じゅぎょう	名，サ変	传授知识、技术、手艺
宿題	しゅくだい	名	作业；研究中的问题
主権	しゅけん	名	主权
手術	しゅじゅつ	名，サ変	手术刀；手术
首相	しゅしょう	名	首相
手段	しゅだん	名	手段
主張	しゅちょう	名，サ変	主张
出席	しゅっせき	名，サ変	出席
出張	しゅっちょう	名，サ変	出差
首都	しゅと	名	首都
趣味	しゅみ	名	兴趣、爱好；乐趣、喜好
種類	しゅるい	名	种类
順序	じゅんじょ	名	顺序、次序；步骤
順調	じゅんちょう	名，形動	顺利、一帆风顺
準備	じゅんび	名，サ変	准备
消化	しょうか	名，サ変	消化；吸收、消化知识等；完成
紹介	しょうかい	名，サ変	介绍
正月	しょうがつ	名	正月
商業	しょうぎょう	名	商业
状況	じょうきょう	名	状况
情況	じょうきょう	名	情况
条件	じょうけん	名	条件
証拠	しょうこ	名	证据
常識	じょうしき	名	常识
上手	じょうず	名，形動	娴熟；客套
状態	じょうたい	名	状况、状态
上達	じょうたつ	名，形動	学习、技能长进、进步
冗談	じょうだん	名	玩笑、笑话
承知	しょうち	名，サ変	知道；同意；许可；原谅
象徴	しょうちょう	名，サ変	象征
商売	しょうばい	名	生意；职业
消費	しょうひ	名，サ変	消费、支出
丈夫	じょうぶ	形動	健康的；结实的
情報	じょうほう	名	情报；消息
証明	しょうめい	名，サ変	证明
正面	しょうめん	名	前面；针锋相对
将来	しょうらい	名	将来
初級	しょきゅう	名	初级
食事	しょくじ	名，サ変	吃饭、饮食、饭菜
食品	しょくひん	名	食品
植物	しょくぶつ	名	植物
食料	しょくりょう	名	食物
女性	じょせい	名	女性
処置	しょち	名，サ変	处理、措施；治疗
食器	しょっき	名	餐具
知らせる	しらせる	他下一	通知、告诉；通报、预告
調べる	しらべる	他下一	调查、研究；查阅（辞书等）；搜索、检查；审讯
尻	しり	名	臀部；后头；末尾；（器物的）底儿
じりじり	じりじり	副	铃声等；油炸的吱吱音；一步一步地移动；（太阳光）灼热；坐立不安
退く	しりぞく	自五	后退；回避；隐退、辞职；让步
私立	しりつ	名	私立
資料	しりょう	名	资料
汁	しる	名	果汁；草木的汁；菜汤；（占的）便宜、好处
知る	しる	他五	知道；注意到、醒悟；分辨、区分；理解内容；感到；预见、预知；体验；相识；相关、介
印	しるし	名	记号、符号；标志；凭证
記す	しるす	他五	写下；记述；做记号、标记；记住
白	しろ	名	白色；洁白（无罪）
白い	しろい	形	白
人格	じんかく	名	人格
進行	しんこう	名，サ変	前进；进展；病情恶化
人口	じんこう	名	人口；众人之口
信じる	しんじる	他上一	信仰；相信；信赖
心身	しんしん	名	身心
人生	じんせい	名	人生
親切	しんせつ	名，形動	体贴、关怀、热情
新鮮	しんせん	形動	新鲜；清新
心配	しんぱい	名，サ変	担心；照顾、张罗
人物	じんぶつ	名	人；人格、性格；有才能的人
新聞	しんぶん	名	报刊
進歩	しんぽ	名，サ変	进步
信用	しんよう	名，サ変	信赖；相信；评价
心理	しんり	名	精神活动、心理
酢	す	名	醋
随分	ずいぶん	副，サ変	非常；比较；特别；够呛；冷酷
吸う	すう	他五	呼吸；吸烟；吸收
数学	すうがく	名	数学
末	すえ	名	末尾；结果；将来；排行最后；末世；无足轻重之事
据える	すえる	他下一	摆放；稳定下来；安置；让……坐下
姿	すがた	名	姿势；外观、打扮；状况、情况；物体的形状；身影
好き	すき	形動	喜爱的；随心所欲
過ぎる	すぎる	自上一	通过、穿过；超过；经过、经历；结束、过去；过期；过度、过分；胜于
空く	すく	自五	空；闲下来、手空出来
透く	すく	自五	透明
直ぐ	すぐ	副	马上；不久；（距离）很近；容易、轻易
救う	すくう	他五	救助；挽救；弥补
少ない	すくない	形	少
優れる	すぐれる	自下一	出色、优秀、卓越
凄い	すごい	形	可怕、吓人；非常、特别；表示惊讶、惊叹的心情
少し	すこし	副	少量、少数；一点点；稍微；一会儿
過ごす	すごす	他五	度过；过分、过度
涼しい	すずしい	形	凉快；清爽、爽快
進む	すすむ	自五	前进；进展；进入；进步；恶化；愿意、积极；旺盛；钟表快
雀	すずめ	名	麻雀；消息通
進める	すすめる	他下一	向前进；进展；晋升；增加（食欲）；把时间调快；提高程度
勧める	すすめる	他下一	建议；劝、劝诱
薦める	すすめる	他下一	推荐、推举
廃れる	すたれる	自下一	过时、不流行；衰弱、衰落
すっかり	すっかり	副	全部、完全；非常
すっきり	すっきり	副	心情爽快；整洁、清爽；明了
ずっと	ずっと	副	时间、距离相隔阂；一直、不停地；笔直；……得多
酸っぱい	すっぱい	形	酸
既に	すでに	副	已经、到那时为止
捨てる	すてる	他下一	扔掉；放弃；抛弃、遗弃
砂	すな	名	沙子
素直	すなお	形動	正直、诚实；坦率
即ち	すなわち	接続	即、也就是说
素晴らしい	すばらしい	形	出色；非常、特别
全て	すべて	副	全部
滑る	すべる	自五	下滑；滑溜；打滑；考试落第；地位下降；说溜嘴
住まう	すまう	自五	居住
済ます	すます	他五	结束；偿还；对付、将就；解决
隅	すみ	名	角落
住む	すむ	自五	居住
済む	すむ	自五	结束；足够、可以；解决
澄む	すむ	自五	清澈；天空无云；声音清亮；没有邪念
相撲	すもう	名	相扑
する	する	サ変	做、干；表示人的感觉；表示某种状态；处于某种状态；值（多少钱）、要；戴、佩
狡い	ずるい	形	狡猾、滑头、奸诈
鋭い	するどい	形	锋利的；尖锐的；敏捷的
座る，坐る	すわる	自五	坐；就任
背	せ	名	脊背；后防；身高
所為	せい	名	原因、缘故
性格	せいかく	名	性格；性质
正確	せいかく	形動	正确
生活	せいかつ	名，サ変	生活；生计
制限	せいげん	名，サ変	限制
成功	せいこう	名，サ変	成功；事业有成
生産	せいさん	名，サ変	生产
政治	せいじ	名	政治
性質	せいしつ	名	天性、本性；特性
青春	せいしゅん	名	青春
精神	せいしん	名	精神、意志
成績	せいせき	名	成绩；工作的成果
生徒	せいと	名	中学生、高中生等
制度	せいど	名	制度
政府	せいふ	名	政府、内阁
生命	せいめい	名	生命、寿命；在某一领域的活动；精华、精髓
整理	せいり	名，サ変	整理、整顿；裁减、缩减；偿还
成立	せいりつ	名，サ変	成立；通过议案；实现
世界	せかい	名	世界上；生活圈；特定的范围
責任	せきにん	名	责任；职责
世間	せけん	名	人世间；世上的人们；交际、活动的范围
折角	せっかく　	副	费周折、好不容易；特意；难得的尽力
絶対	ぜったい	名，副	绝对；决（不）、决（没有）
説明	せつめい	名，サ変	说明
是非	ぜひ	名，副	是非、善恶；一定、必定、肯定
狭い	せまい	形	空间狭小、幅度狭窄；看法、观点贫乏
迫る	せまる	自五	距离迫近；时间临近、逼近；急迫、急促；强迫、迫使
せめて	せめて	副	至少、哪怕是……也好
攻める	せめる	他下一	攻击、进攻、攻打
責める	せめる	他下一	非难；严厉要求
世話	せわ	名，サ変	照看、照顾；棘手、麻烦；介绍、斡旋
線	せん	名	线；铁路线；电线、电话线；方针
選挙	せんきょ	名，サ変	选举
先月	せんげつ	名	上个月
先生	せんせい	名	老师；对医生、律师、政治家的敬称
全然	ぜんぜん	副	（后接否定）一点、完全、根本
戦争	せんそう	名	战争
洗濯	せんたく	名，サ変	洗涤
宣伝	せんでん	名，サ変	宣传；吹嘘、鼓吹
先輩	せんぱい	名	先辈、前辈、老资格；先入学或毕业的人、先参加工作的人
全部	ぜんぶ	名	全部、整体上
添う	そう	自五	陪伴；结为夫妇；吻合、能实现
沿う	そう	自五	沿着；遵照、按照
増加	ぞうか	名，サ変	增加
相互	そうご	名，形動	相互
総合	そうごう	名，サ変	综合
想像	そうぞう	名，サ変	假定、假设；推测；空想
相談	そうだん	名，サ変	听取意见；协商、商量
相当	そうとう	名，サ変，行動，副	相配；相当于；相当程度
底	そこ　	名	底部、底下；心底、内心；降到最低的物价或行情等
其処	そこ　	代	指距对方较近的场所、那儿；那一点
そこで	そこで	接続	于是、因此；那么
損なう	そこなう	他五	伤害、损害；有损于；错过、漏掉；险些
組織	そしき	名，サ変	成立、结成；构成
そして	そして	接続	然后、于是
注ぐ	そそぐ	自他五	流入、汇入；落下、降下；浇、洒；灌、注入；灌溉；集中
育てる	そだてる	他五	使……成长；促进发育、培养
そちら	そちら	代	那边；你；那个；那一位
卒業	そつぎょう	名，サ変	从学校毕业
外	そと	名	外面；户外；外边、外面；外部；外表、脸上
備える	そなえる	自下一	准备；备置、备有；具备、具有
其の	その	連体	那、那个；那时、那件事
そのまま	そのまま	副	原原本本、原封不动的；就那样地；一模一样
側	そば	名	旁边；刚……之后、刚……不久
聳える	そびえる	自下一	高耸、耸立
祖父	そふ	名	祖父、爷爷、外公
祖母	そぼ	名	祖母、奶奶、外婆
背く	そむく	自五	违背、不遵从；违反；辜负
空	そら	名	天、空中；天气；心情；谎言、假话；背诵
それ	それ	代	那个；那件事；那时
それだけ	それだけ	副	那些、那么多；唯独那个；只有那些、只限于那些
それで	それで	接続	那么；因此；后来
揃う	そろう	自五	汇集、聚集；齐全、成套；整齐、一致
揃える	そろえる	他下一	使……汇集、聚集；使齐备、凑齐；摆整齐；使……一致、整齐
そろそろ	そろそろ	副	慢慢地、静悄悄地；渐渐地、一点点地
存在	そんざい	名，サ変	存在
体育	たいいく	名	体育
第一	だいいち	名	第一、最初；主要；首先
大学	だいがく	名	大学
大事	だいじ	名，形動	大事；重要、关键；贵重的、珍贵的
大した	たいした	連体	了不起；不算什么、不要紧
対象	たいしょう	名	对象
大丈夫	だいじょうぶ	形動	安全、放心；没关系、不要紧
対する	たいする	サ変	向对面；对于；对抗；对照、与……相比
大切	たいせつ	形動	贵重、心爱、谨慎
体操	たいそう	名	体操；活动、运动
大体	だいたい	名，副	大体上、大概、概略；基本上、差不多；全部；本来、原来
大抵	たいてい	副	通常；大概、也许；适度、适当；普通
態度	たいど	名	态度、举止；看法、想法
代表	だいひょう	名，サ変	代表；典型的、有代表性的
大分	だいぶ	副	数量多、很、颇、相当地
大変	たいへん	形動	够受的、不得了、不简单；重大、严重；非常
太陽	たいよう	名	太阳
平ら	たいら	形動	平、平坦；平稳、安静、心平气和
絶える	たえる	自下一	结束、终止、停止；消失、灭亡
耐える	たえる	自下一	忍耐、忍受；承受、经得住；（以否定的形式表示）不止的、不堪
倒す	たおす	他五	打倒、推倒；打败；打倒、推翻
倒れる	たおれる	自下一	倒塌；病倒、死；倒台；倒闭、破产
高い	たかい	形	高；在上面、在上空；声音的频率高；工资、费用、价格高；地位高；评价高、声誉高；仪
互いに	たがいに	副	相互、双方
高まる	たかまる	自五	变高、提高、高张；增大、扩大
高める	たかめる	他下一	提高、增高；增加、强化
耕す	たがやす	他五	耕（地）
宝	たから	名	财宝、宝贝
炊く	たく	他五	煮饭
焚く	たく	他五	烧；薰香
抱く	だく	他五	抱；心怀
沢山	たくさん	副	众多、很多、许多；足够、够了
逞しい	たくましい	形	体格健壮；意志坚定的
巧み	たくみ	形動	巧妙、精巧
企む	たくらむ	他五	打算、企图；预谋
蓄える	たくわえる	他下一	储备、储存；留（胡须、头发）
竹	たけ	名	竹；以松竹梅分等级时的第二
確か	たしか	副，形動	确实；可靠的；正常的；大概、或许
確かめる	たしかめる	他下一	确认、核实
出し抜く	だしぬく	他五	趁机、抢先下手
助かる	たすかる	自五	被救、脱险；省钱、省事；有帮助
助ける	たすける	他下一	救助；帮助；促进
尋ねる	たずねる	他下一	寻找、寻求；询问、打听
訪ねる	たずねる	他下一	访问、拜访
ただ	ただ	名	普通的、一般的；不在乎、不计较；免费
ただ	ただ	副，接続	唯、只；仅；但是、然而
唯今	ただいま	副，感	现在；刚刚；马上；（外出回来的应酬话）我回来了
戦う，闘う	たたかう	自五	打仗、战斗；竞争
叩く	たたく	他五	拍、敲、擂；拍松软；非难、攻击；试探、探问；杀价
正しい	ただしい	形	正确的、对的；正当、正统；端正；正式的
畳	たたみ	名	榻榻米
畳む	たたむ	他五	折叠；关闭、收拾；藏在心里；杀、干掉
漂う	ただよう	自五	漂流、飘浮；飘香；洋溢、充满
立つ	たつ	自五	竖立；站起来；刺、扎；冒起、升起；门关着；决定、定下；开设；成立；保持、保住；被
絶つ	たつ	他五	断绝；停止、中断；结束
断つ	たつ	他五	剪断、切断；戒、忌；遮断、挡住
達する	たっする	サ変	到达、抵达；达到；精通；实现
縦	たて	名	竖、纵；上下关系
立てる	たてる	他下一	竖立起来；刺、扎；扬起波浪、使冒烟；关闭；设立；决定；让人当；尊敬、给面子；传播
例えば	たとえば	副	例如、比方说
例える，喩える	たとえる	他下一	比喻；举例
辿る	たどる	他五	沿着前进、边走边找；追寻、探索；寻访
棚	たな	名	架；大陆架
谷	たに	名	山谷
種	たね	名	种子；血统、种；原因、材料；做菜的材料；戏法、魔术等的招数
楽しい	たのしい	形	快乐、愉快
楽しむ	たのしむ	自他五	享受、欣赏；期待、盼望
頼む	たのむ	他五	享受、欣赏；期待、盼望
旅	たび	名	旅行、观光
度	たび	名	时候；每次……；回、次
度度	たびたび	副	多次、再三
だぶだぶ	だぶだぶ	副，サ変	（衣服等）过于肥大；（人）肥胖；（液体）过多
多分	たぶん	副	也许、或许、可能；许多、很多
食べる	たべる	他下一	吃；生活、生计
玉	たま	名	球、硬币
卵	たまご	名	鸡蛋、鸟蛋等；未出师或未毕业的人、初出茅庐者
騙す	だます	他五	欺骗；使平静、使平息
たまに	たまに	副	偶尔
溜まる	たまる	自五	聚集、汇集；积压、停滞
貯まる	たまる	自五	积攒、积存
黙る	だまる	自五	沉默、不吱声；不打招呼、不征得同意；不反驳
為	ため	名	有益；因为、为了
駄目	だめ	形動	无用；白费；不可挽救；做不到、不可能；不行
試す	ためす	他五	试验、尝试、考验
保つ	たもつ	他五	保住；保持
便り	たより	名	消息、书信
頼る	たよる	他五	投靠；依赖、依靠
だらしない	だらしない	形	散漫、马马虎虎；没出息、不争气；不检点、放荡
垂らす	たらす	他五	垂下、披下；流、淌
足りる	たりる	自上一	足够；可以、将就
怠い	だるい	形	倦怠、浑身无力
弛む	たるむ	自五	放松、松开；松懈、松弛
誰	だれ	代	谁
単位	たんい	名	单位；基本构成因素；学分
単語	たんご	名	单词、词汇
誕生	たんじょう	名，サ変	出生、诞生；创设、创办
男性	だんせい	名	男性
段段	だんだん	副	逐渐的
血	ち	名	血液；血脉
小さい	ちいさい	形	（体积、面积、身长等）小；（数量、程度）微少、小、低；（年龄）幼小；琐碎、细小；
小さな	ちいさな	連体	小、微小
知恵	ちえ	名	智慧
地下	ちか	名	地下；死后的世界；非法的、秘密的世界
近い	ちかい	形	近、靠近；最近、近日；亲近；亲密；近似于
誓う	ちかう	他五	发誓、宣誓
違う	ちがう	自五	不同、不符合；错误；不正常
近頃	ちかごろ	名	最近
力	ちから	名	体力；力、重力、尹力、压力；能力、实力；得力于……；效用、功效；权力、影响力；暴
遅刻	ちこく	名，サ変	迟到
知識	ちしき	名	知识
地図	ちず	名	地图
父	ちち	名	父亲；创始者
地方	ちほう	名	地方、地区；地方上、外地
注意	ちゅうい	名，サ変	留神、注意；小心、谨慎；忠告、警告
中央	ちゅうおう	名	正中间；中央
中学校	ちゅうがっこう	名	中学
抽象	ちゅうしょう	名	抽象
中心	ちゅうしん	名	中央、中心；处于最重要的位置的人或物；焦点、要点
注目	ちゅうもく	名，サ変	注目、注视
注文	ちゅうもん	名，サ変	定做、订货、点菜；要求、条件
調査	ちょうさ	名，サ変	调查
調子	ちょうし	名	声调；节奏；语调、笔调；做法；情况、样子；气势
ちょうど	ちょうど	副	正好、恰好；恰巧、碰巧；简直
直接	ちょくせつ	名，副	直接
ちょっと	ちょっと	副	一会儿、一下；顺便；相当、颇为；喂；一时（难以）、（不大）容易
地理	ちり	名	地势、地形、地理；地理情况、路形
散る	ちる	自五	凋谢、落；离散、分散；消散；渗；消肿；涣散、不专心
つい	つい	副	一不小心、终于；刚刚
追加	ついか	名，サ変	追加、再增加、补上、添补
追求	ついきゅう	名，サ変	追求
一日	ついたち	名	一号、一日
就いて	ついて	接	关于、就
序に	ついでに	副	顺便；就便
遂に	ついに	副	最后、结局、终于
費やす	ついやす	他五	耗费、花费；浪费、白费
通学	つうがく	名，サ変	上学、走读
通勤	つうきん	名，サ変	上班
通じる	つうじる	自他上一	通往、通向；通（电）；领会、理解、沟通；精通、熟悉；行得通；通用；男女私通；包括
使う	つかう	他五	使用、利用工具；雇佣；使用语言；使用手段；做某事
掴む	つかむ	他五	拽住、揪住；抓住、把握住
疲れる	つかれる	自下一	疲劳、劳累；变旧
月	つき	名	月球；月
次	つぎ	名	下次、下回；隔壁、邻室
尽きる	つきる	自上一	用完、用尽；结束；限于、最适合于
付く	つく	他五	附上、粘附、沾上；留下痕迹；附属、附带；具备、设有；带有；掌握、学会；扎根；跟随
突く，衝く	つく	他五	扎、刺、戳；撞、顶；扶、把；严厉地追究；冒着、顶着；扎心、痛心
就く	つく	自五	置身于
着く	つく	自五	到达；触及
継ぐ	つぐ	自五	继承；缝补、修缮；添加、续上
机	つくえ	名	书桌
尽くす	つくす	他五	竭尽全力；为……效力、报效、贡献
作る	つくる	他五	制作、加工；栽培；耕种；制定；创作；排成、形成；设立；创下纪录等；抽空；交朋友、
造る	つくる	他五	建设、建造；造币；设计庭院；酿造；创造
繕う	つくろう	他五	缝补、修缮；整理、修饰；敷衍
付ける	つける	他下一	靠近、靠紧；贴上、拴上；涂抹；安装；附上、加上；使陪伴、使跟随；留下痕迹；着手、
就ける	つける	他下一	使就座；就职、使从事；使从师
着ける	つける	他下一	佩带、带伤、系上；抵达、到达；把……靠在、贴在
告げる	つげる	他下一	让……听、公布；通知、告知
都合	つごう	名，サ変	方便、合适；情况、关系、理由；准备、安排、抽出；合计、总共
伝える	つたえる	他下一	通知、传达；传授、继承；从海外引进；传递热、光、声音等
伝わる	つたわる	自五	被传递、被传达；传播、传布；沿着；继承；传来
土	つち	名	土壤、泥土；地面、土地
続く	つづく	自五	继续、持续；连接不断；连接着、挨着；紧接着
続ける	つづける	他下一	继续、持续；连接在一起
包む	つつむ	他五	包装；覆盖、笼罩、沉浸；包红包奉上；隐瞒、藏在心里
勤める	つとめる	他下一	工作、做事、任职
努める	つとめる	自下一	努力、尽力
繋がる	つながる	他五	连接；相关、牵涉；有血缘关系；接通电话
常	つね	名	平时；常青；普通（人）
常に	つねに	副	时常、总是
募る	つのる	自他五	招募、征集、招聘；增强
翼	つばさ	名	翅膀、机翼
潰す	つぶす	他五	弄碎、压碎；宰杀；堵死、赌上；丢脸、损害名誉；消磨时间；败家、使破产；毁坏
潰れる	つぶれる	自下一	倒塌、挤坏、压坏；丢人、丢脸；倒闭、破产；坏了、泡汤；痛心、悲痛
妻	つま	名	妻子
躓く	つまずく	自五	绊倒、跌倒、摔跤；失败
撮む，抓む，摘まむ	つまむ	他五	摘、掐；下筷子、吃；摘要、摘取
つまらない	つまらない	形	无趣、无聊；不足挂齿
つまり	つまり	副	总之
詰まる	つまる	自五	塞满、挤满；堵塞；困窘、窘迫；收缩
罪	つみ	名	罪孽、罪过；犯罪、罪刑；处罚；罪责
積む	つむ	他五	堆积；装运、装载；积累；积蓄、积攒
摘む	つむ	他五	摘取、掐、采
爪	つめ	名	指甲；（琴）拔子
冷たい	つめたい	形	寒冷；冷淡、冷漠
詰める	つめる	自他下一	装放、塞入；挤紧、紧靠；憋紧；缩短；节约、节俭；值班、上班；不停地、持续
積もり	つもり	名	意图、打算；期待、预订；就当作……、就算是……
積もる	つもる	自五	积、堆积；累积、积攒
強い	つよい	形	强、强大；健康、结实；坚强、刚强；对……有抵抗力；棒、过硬；严格、强硬；牢固、紧
辛い	つらい	形	难过、难受、难堪；冷酷、刻薄、残酷
吊る	つる	自他五	悬挂、挂；吊起；上吊；向上翘；抽筋
釣る	つる	他五	垂钓；引诱、诱骗
吊るす	つるす	他五	吊起、挂起
連れる	つれる	他下一	带、领
手	て	名	手；把手；动物的前脚；人手；手段、计略、策略；象棋等的走法；笔迹；种类；方向；手
出会う	であう	自五	遇见、碰上
手足	てあし	名	手脚；左右手、俯首帖耳的人
抵抗	ていこう	名，サ変	抵抗；抗拒；反抗；阻力、电阻
程度	ていど	名	程度、水平；标准；限度、范围；大约、大概
丁寧	ていねい	形動	彬彬有礼、恭恭敬敬；详细地、细心地
出掛ける	でかける	自下一	外出、出发；访问、串门
敵	てき	名	敌人、仇敌；竞争对手
適当	てきとう	形動	合适、恰当；适度、适当；马虎、敷衍
出来る	できる	自上一	做好、做完；制作、制造；出产；形成、出现；天生的；设立、成立；可能；好、不错；有
出口	でぐち	名	出口
手頃	てごろ	形動	正合手；合适、符合
手数	てすう	名	费事、麻烦、费心
手伝う	てつだう	自他五	帮助；加上
手続	てつづき	名	手续
手間	てま	名	所费的时间和劳力
出迎える	でむかえる	他下一	出迎、迎接
でも	でも	接続	但是、可是、不过
寺	てら	名	寺庙
照らす	てらす	他五	照射、照耀；比较、参观
照る	てる	自五	照射、照耀
出る	でる	自下一	外出；迈出；出发、离去；出现；突出、露出；流出；出席；接电话；到达；超过；出版、
店員	てんいん	名	店员
天気	てんき	名	天气；晴天；心情
伝統	でんとう	名	传统
天麩羅	てんぷら	名	油炸食品；镀金
電話	でんわ	名，サ変	电话（机）；（打）电话
問う	とう	他五	问；追查；（用否定形式表示）不管
どう	どう	副	怎么样、怎么、如何
答案	とうあん	名	答案、答卷
どうか	どうか	副	请；好歹会、总会；是否；不正常、可笑
峠	とうげ	名	山顶；极点、顶点
どうして	どうして	副，感	怎样；为什么；哪里
如何しても	どうしても	副	务必；怎么也
どうせ	どうせ	副	反正
どうぞ	どうぞ	副	设法；请；请吧
動物	どうぶつ	名	动物
当分	とうぶん	副	暂时
どうも	どうも	副	怎么也；总觉得；实在；（用来打招呼或表示）感谢、歉意
遠い	とおい	形	（距离）远；（时间）长；关系疏远；迟钝、不敏锐；相差悬殊
通す	とおす	他五	使……通行；领进；使……穿过；使……透过；看完；使……合格；一直；通过；经过；坚
通り	とおり	名	街道；通行；水、空气的流通；（声音的）响亮；评价、声誉；理解、领会；同样的状态
溶かす，融かす，解かす	とかす	他五	溶解、融化
尖る	とがる	自五	尖；（神经）过敏；发怒
時	とき	名	时间；时辰；时候；时代；季节；当时的；好时机；场合
時時	ときどき	副，名	时时；各个时期
解く	とく	他五	解开、解除；解答；消除；废除
説く	とく	他五	说明
溶く	とく	他五	融化、化开
得	とく	名，形動	收益；得好处、方便、合算
特に	とくに	副	格外、特别
特別	とくべつ	副，形動	特别、特殊
時計	とけい	名	钟表
解ける	とける	自下一	松了；怒气（消了）；答出、解开；解除（禁令等）
溶ける，融ける	とける	自下一	溶解；溶化
遂げる	とげる	他下一	达到、完成；最终
何処	どこ	代	哪儿
所，処	ところ	名	地点；地区；住处；余地；部分；之处；正……的时候；内容、范围
ところが	ところが	接続	然而
都市	とし	名	都市
年	とし	名	年；年龄
図書	としょ	名	图书
年寄り	としより	名	老年人
閉じる	とじる	自他上一	关、闭；关、合上；结束、关闭
土地	とち	名	土地；地面、地皮；当地
とちら	とちら	代	哪儿；哪里；（敬语）哪位
突然	とつぜん	副	忽然
とても	とても	副	怎么也；极其
届く	とどく	自五	送到、到达；及、够；无遗漏、周到；（心愿）得偿、（希望）达到
届ける	とどける	他下一	报告；送到
整える	ととのえる	他下一	整理
止まる	とどまる	自五	止于、限于
留まる	とどまる	自五	停留
止める	とどめる	他下一	止住、停止；限于（某种程度）
留める	とどめる	他下一	留下
唱える	となえる	他下一	念诵；高喊；提倡；倡导
どなに	どなに	代	（“だれ”的敬语）哪位
隣	となり	名	邻居；邻近
怒鳴る	どなる	自五	大声喊、怒喊
兎に角	とにかく	副	总之；姑且（不谈）
どの	どの	連体	哪个
飛ばす	とばす	他五	使……飞、放；溅、喷；飞驰、疾驰；跳过；散布；被降职
跳ぶ	とぶ	自五	跳、越
飛ぶ	とぶ	自五	飞、飞跑；飞扬、飞溅；断、脱落；烟消云散、无影无踪；（号码等）不连接；散布、流传
乏しい	とぼしい	形	不足、缺乏经验；贫困
止まる	とまる	自五	原地不动；中止；（鸟、飞虫等）落于某处休息、栖在
留まる	とまる	自五	固定住；留（在印象中）
泊まる	とまる	自五	停泊；投宿、住宿
富む	とむ	自五	富裕；丰富、富于
止める	とめる	他下一	使……停下；堵住；制止、禁止
留める	とめる	他下一	固定住；系、扣；留住、记住
友達	ともだち	名	友人、朋友
伴う	ともなう	他五	伴随；带领；相称
共に	ともに	副	一起；都、均；同时、相伴着
捉える	とらえる	他下一	把握、领会；占据
取り上げる	とりあげる	他下一	拿起；采用、受理；没收；接生
取り扱う	とりあつかう	他五	使用、处理；办理；对待
取り組む	とりくむ	自五	对手；（未处理某事而）埋头苦干
取り込む	とりこむ	自他五	拿进来；占领、占为己有；侵吞；忙乱、忙碌
採る	とる	他五	采取、采用；选择；雇用
執る	とる	他五	处理、实行；拿；执笔
取る	とる	他五	拿、握、攥；除掉、去掉；夺取、偷盗；掌权；掌管天下；获得；拿取（食物）、进行（睡
捕る	とる	他五	抓住
何れ	どれ	代	哪个
奴隷	どれい	名	奴隶；耽迷……的人
とんでもない	とんでもない	形	意外；哪有的事
どんどん	どんどん	副	（鼓等的）咚咚声；接连不断、一个劲儿的
名	な	名	名称、名字；名声、声誉；名义、名目
無い，亡い	ない	形	无、没有；死去
ない	ない	補助動词	不、没有
内外	ないがい	名	内外、国内外；左右、前后
内向	ないこう	名	内向
内緒	ないしょ	名	秘密；生计、生活
内容	ないよう	名	内容
尚，猶	なお	副	尚、仍然；更
治す，直す	なおす	他五	修改、订正；治疗；更改、变更；（在动词的连用形后）重做、改作
中	なか	名	内部、里面；（事物）进行中；（顺序）中等、中级
長い，永い	ながい	形	距离远的、长的；（时间）长；永别；耐性好
流す	ながす	他五	使液体流动；冲；冲洗；播放（声音、音乐等）；传播；流放；（艺人、出租车等）串街揽
中中	なかなか	副，形動	非常、相当（下接否定）轻易、容易
眺める	ながめる	他下一	眺望、凝视
流れる	ながれる	自下一	流、淌；漂流；（如水流般）流动、飘动；（岁月、时光）流逝；漂泊；（典当东西）当死
泣く	なく	自五	啼哭、哭泣；感觉为难、吃苦头、懊悔；忍痛降价
鳴く	なく	自五	（鸟等）鸣叫、啼叫
無くす	なくす	他五	消失；丢失
無くなる	なくなる	自五	完、尽、遗失
亡くなる	なくなる	自五	死、故去
殴る	なぐる	他五	殴打
嘆く	なげく	他五	悲伤、忧愁；愤慨
投げる	なげる	他下一	投、扔；跳入；投射；放弃
為さる	なさる	他五	（する）的尊敬语；接动词连用形做敬语用
何故	なぜ	副	为什么、何故
夏	なつ	名	夏天
懐かしい	なつかしい	形	（令人）怀念、眷恋、依恋
何	なに	代，副，感	什么；那、那个任何；（用以否定对方的话）哪里、没什么；表示意想不到、惊愕
何より	なにより	連語	比什么都（好）
鍋	なべ	名	锅；火锅
名前	なまえ	名	姓名、名字；（事物的）名称
怠ける	なまける	自下一	懒惰
波，浪	なみ	名	波浪；波浪形的声波、地震波、电波等
並	なみ	名，接尾	普通、一般、平常排列、并列；每；同样
涙	なみだ	名	眼泪；同情
滑らか	なめらか	形動	光滑；流利、顺溜
悩む	なやむ	自五	（肉体的）痛苦；烦恼；（接动词连用形之后，表示该动作）不能顺利进行
習う	ならう	他五	学习、练习
倣う	ならう	他五	模仿
鳴らす	ならす	他五	鸣响、（使）出声；出名、驰名；数落、一一陈述
並ぶ	ならぶ	自五	排成列；匹敌
並べる	ならべる	他下一	排列；（整齐地）摆；比较；一一列举
成る，生る	なる	自五	结果实；成为、到达；变成……状态；变得……；到（某时刻、某个数量）；起作用；（お
鳴る	なる	自五	鸣、响；驰名、闻名
なるべく	なるべく	副	尽可能
慣れる	なれる	自下一	习惯、习以为常；熟练；惯于……
馴れる	なれる	自下一	驯熟
何でも	なんでも	連語，副	不管什么；不论有什么；大概；据说是
何となく	なんとなく	副	总觉得、不由得
似合う	にあう	自五	合适、般配
匂い，臭い	におい	名	香气；臭味；气息、情绪
匂う，臭う	におう	自五	散发气味；（颜色）显得鲜艳；（做坏事的）样子、迹象
苦い	にがい	形	苦；不愉快、痛苦
苦手	にがて	名，形動	不好对付的人；不擅长、不善于
賑やか	にぎやか	形動	热闹、繁华；闹哄哄
握る	にぎる	他五	握、攥；攥饭团；掌握
肉	にく	名	（人的）肌肉；肉类；果肉；肉体；（肌肉或者物体的）厚度；印泥
憎い，悪い	にくい	形	可憎、讨厌；漂亮、令人佩服
難い，悪い	にくい	接尾	（接动词连用形）很难、不好办
憎む	にくむ	他五	憎恶、恨
逃げる	にげる	自下一	逃跑；逃避（责任等）
濁る	にごる	自五	混浊；污浊、混乱；（声音）不清晰；发浊音
西	にし	名	西风；（佛）西天、净土；西欧各国
偽，贋	にせ	名	假冒、赝品
日常	にちじょう	名	日常、平常
日記	にっき	名	日记；日记本
担う，荷う	になう	他五	担、挑；担负
鈍い	にぶい	形	钝的；（光、音）弱；（动作、思想）迟钝、迟缓
日本	にほん	名	日本
荷物	にもつ	名	货物、行李；负担、累赘
入学	にゅうがく	名，サ変	入学
入門	にゅうもん	名，サ変	成为弟子；入门手册；初学
睨む	にらむ	他五	瞪；估计；监视、盯上
似る	にる	自上一	像、似；大同小异
煮る	にる	他上一	煮
庭	にわ	名	庭院；特定场所
人気	にんき	名	人望、人缘；风气
人形	にんぎょう	名	偶人；傀儡、没有独立性的人
人間	にんげん	名	人类；人品
認識	にんしき	名，サ変	认识、理解
抜く	ぬく	他五	拔出；选出；除掉；窃取；省掉；超过；胜过；（作补助动词）做到底
脱ぐ	ぬぐ	他五	脱掉、摘掉；脱下丢开
拭う	ぬぐう	他五	擦掉；消除、洗刷
抜ける	ぬける	自下一	脱落、掉下；溜走；漏掉；穿过；消失；迟钝
盗む	ぬすむ	他五	偷盗；偷闲；背着、偷偷地；剽窃
布	ぬの	名	布；（接在其他名词之前表示）平、水平
塗る	ぬる	他五	涂、抹
温い	ぬるい	形	半冷不热、不够热；不严厉
根	ね	名	根；根底；根源、根据
願う	ねがう	他五	期望；请求、要求
猫	ねこ	名	猫；艺妓
値段	ねだん	名	价格
熱	ねつ	名	热；热度；热情
熱意	ねつい	名	热忱、热情
熱心	ねっしん	名，形動	热心、热情
熱中	ねっちゅう	名，サ変	热衷于
粘る	ねばる	自五	粘、发粘；坚持不懈
寝坊	ねぼう	形動，名，サ変	睡懒觉的（人）
眠い	ねむい	形	想睡的
眠る	ねむる	自五	睡；长眠、死；埋藏、放置、不被利用
狙う	ねらう	他五	瞄准；伺机；以……为目标
寝る	ねる	自下一	躺下；睡觉；因病卧床；积压
練る，煉る	ねる	自他五	列队游行；揉、和（面粉、馅等）；加工、锤炼；提高、修养
年中	ねんじゅう	名，副	一年间；始终
農業	のうぎょう	名	农业
農民	のうみん	名	农民
残す	のこす	他五	剩下；留下
残る	のこる	自五	留下；剩余；残留；流传后世
載せる	のせる	他下一	放在……上；装载、装运；登载
乗せる	のせる	他下一	使……乘坐；传播、传导；和着（节拍、节奏）；骗人、欺骗；吸收参见、让参加
除く	のぞく	他五	除去；除外
覗く	のぞく	自他五	露处（物体的）一部分；从缝隙中看；窥视；粗略地看一下；向下看
喉	のど	名	喉咙、咽喉；歌声
伸ばす	のばす	他五	伸展；伸直、使……平坦；稀释；打倒、打趴在地；扩展、发展
延ばす	のばす	他五	延长日期、时间
伸びる	のびる	自上一	变长、（褶皱等）伸展；失去弹性；增长、发展；筋疲力尽
延びる	のびる	自上一	延长、延期；时间变长
延べ	のべ	名	总计
述べる	のべる	他下一	叙述、阐述
上る	のぼる	自五	向上移动；溯流航行；就高位；从地方向首府移动；达到、高达；被提起
登る	のぼる	自五	登、爬、攀
昇る	のぼる	自五	升腾、升起
飲む，呑む	のむ	他五	喝、喝酒；抽、吸；接受；压倒、胜过；隐匿、隐藏
乗り換える	のりかえる	自下一	换乘；改变（主张、方针、所属等）
乗る	のる	自五	乘、坐、骑；登上；和着、附和；乘势、乘机；上当、受骗；附着、上膘
載る	のる	自五	放在上面；刊载、登载
呑気	のんき	名，形動	悠闲的
のんびり	のんびり	副，サ変	悠然自得、逍遥自在
葉	は	名	树叶
歯	は	名	牙齿；齿状物、器物的齿
場合	ばあい	名	场合、时候；情况、状态
配達	はいたつ	名，サ変	投递、投送
入る	はいる	自五	进入；移动；缩入、太阳落山等；入学、进公司；装进、容纳；进入（某种状态、时期）；
生える	はえる	自下一	生长
墓	はか	名	墓
馬鹿	ばか	名，形動	愚蠢的人；无益的；过分、极端；不好使、不中用；……呆子
葉書	はがき	名	明信片
捗る	はかどる	自五	顺利进展、推进
秤	はかり	名	秤
計る	はかる	他五	计算；评价、预测；欺骗、诈骗
図る	はかる	他五	计划；处理、照顾、安排
測る	はかる	他五	测量
量る	はかる	他五	测量、计算
謀る	はかる	他五	图谋、策划
穿く，履く	はく	他五	穿（鞋、袜等）
掃く	はく	他五	打扫；轻涂
吐く	はく	他五	喷出；呕吐、吐出；冒出；说出、吐露；招供
莫大	ばくだい	形動	莫大、极大
激しい	はげしい	形	猛烈；剧烈
励ます	はげます	他五	激励；提高嗓门、厉声
励む	はげむ	自五	勤勉、勤奋
化ける	ばける	自下一	化身为；乔装、冒充；骤变
箱	はこ	名	箱子；（电车、火车）车厢
運ぶ	はこぶ	自他五	进展；运送；前往；推进
挟む	はさむ	他五	夹进、插进；夹；心生……
橋	はし	名	桥
箸	はし	名	筷子
恥，辱，羞	はじ	名	丢脸；廉耻心
弾く	はじく	他五	弹跳、弹力；不沾水；弹；打算盘
始まる	はじまる	自五	开始；开始（老一套行为）；（后接否定表示）无用、白费劲
始め，初め	はじめ	名	最初；起初；以……为首
始める	はじめる	他下一	开始；开始（老一套的行为）；开始做……
場所	ばしょ	名	场所、地方；所占的位置；相扑赛季
柱	はしら	名	支柱；依靠
走る	はしる	自五	跑；行驶、奔驰、运行；逃亡；倾向于（不好的方向）；（文笔）流畅；伸展；突然出现
恥じる	はじる	自上一	羞耻、惭愧；（用否定式表示）不愧为
筈	はず	名	理所当然；预定
恥ずかしい	はずかしい	形	不好意思的；害羞；感到羞愧
外す	はずす	他五	取下、解下；离席；避开；错过
弾む	はずむ	自他五	弹、反弹；气息变粗；情绪高涨、起劲；（一狠心）拿出很多钱
外れる	はずれる	自下一	脱落、掉下；脱离、不合；未中、落空；相悖、不合（道理等）
旗	はた	名	旗帜
肌，膚	はだ	名	皮肤；物体表面；气质
裸	はだか	名	裸体；身无分文；毫不隐瞒、坦诚
畑	はたけ	名	田地、旱田；专业领域
果たす	はたす	他五	实现；光、尽
二十，二十歳	はたち	名	二十岁
働く	はたらく	自他五	劳动、工作；作用；干坏事
二十日	はつか	名	二十号；二十天
はっきり	はっきり	副，サ変	清楚；明确；清晰、明了；干脆、断然
発達	はったつ	名，サ変	（身体、精神等）发育、成长；发达；（低气压、台风的规模）扩大
発展	はってん	名，サ変	发展、扩展；进步；（在酒色上）放荡
発売	はつばい	名，サ変	出售、发售
発表	はっぴょう	名，サ変	发表、表明
発明	はつめい	名，サ変，形動	发明；聪明、伶俐
派手	はで	形動	鲜艳、华美；铺张、显眼
花	はな	名	花；樱花；花道；黄金时代；最好的；精华
鼻	はな	名	鼻子；鼻涕
話	はなし	名	谈话、话题；商量、商谈；故事；传言、谣传；道理；事情
話す	はなす	他五	说、讲；商量、商谈；说（外语等）
放す	はなす	他五	放开、撒开；放掉、放走
離す	はなす	他五	分离、离开；间隔、隔开
放つ	はなつ	他五	派遣；射箭；放；防（火）；放开、解放
花見	はなみ	名	赏（樱）花
華やか	はなやか	形動	引人注目、显赫
離れる	はなれる	自下一	有距离、有差距；离开；分离、分开；脱离、背离
跳ねる	はねる	自下一	跳；飞溅；散戏、散场；（行情）飞涨
母	はは	名	母亲；事物产生的根源、母
幅	はば	名	宽度；势力、威力；伸缩余地、灵活性；差价、幅度
省く	はぶく	他五	精简；节省
嵌める，填める	はめる	他下一	镶、嵌；戴上；欺骗
速い	はやい	形	快、迅速
早い	はやい	形	早；为时尚早、还不到时候；时间短、快
林	はやし	名	树林
流行る	はやる	自五	流行、盛行；（疾病等）流行、蔓延；兴旺
腹	はら	名	腹、肚子；鼓出的部分；内心、想法；度量
払う	はらう	他五	拂、掸；横扫、横砍；支付；倾注、表示
ばらばら	ばらばら	副，形動	（雨点等）连续降落声；支离破碎
針	はり	名	缝衣针；刺、钩子
春	はる	名	春天；明年；最盛期；青春期
張る	はる	自他五	拉、张开；（将液体）装满；设置、摆；固执、坚持（己见）；打（头、脸）、殴打；胀、
貼る	はる	他五	粘贴
晴れ	はれ	名	晴、晴天；隆重、正式、公开；（嫌疑）消除
腫れる	はれる	自下一	肿
晴れる	はれる	自下一	晴；（心情）舒畅；（嫌疑、疑惑）消除
範囲	はんい	名	范围
番号	ばんごう	名	号码
万歳	ばんざい	名，サ変	万岁；可喜、可贺；无可奈何
反対	はんたい	名，サ変	相反、相对；反对
判断	はんだん	名，サ変	判断；占卦
火，灯	ひ	名	火、火焰；灯火、灯光
日	ひ	名	太阳；白昼、白天；一昼夜；（特定的）一天、日子；时期、时代；日期、期限；时候
贔屓	ひいき	名，サ変	照顾、偏袒、偏爱
冷える	ひえる	自下一	变冷、变凉；（感情等）变冷淡
控える	ひかえる	自他下一	（在近旁）等候；拉住、拽住；节制、控制；面临、靠近；写下来
比較	ひかく	名，サ変	比较
東	ひがし	名	东
光	ひかり	名	光、光亮；势力、威力；光明、希望
光る	ひかる	自五	发光、闪光；出众、显眼
引かれる	ひかれる	自下一	被吸引
悲観	ひかん	名，サ変	悲观
率いる	ひきいる	他上一	率领、统率
引き出す	ひきだす	他五	拉出、发挥；提出、提取（存款）
引き続き	ひきつづき	副	继续
引く	ひく	他自五	拉、拽；拔出、抽（签）；收回、缩回；搭拉、拖；引导、领；消减、扣除；引进、安装（
弾く	ひく	他五	弹奏、拉
低い	ひくい	形	低、矮；低贱；低微
悲劇	ひげき	名	（戏剧）悲剧
日頃	ひごろ	名，副	平素、平时
膝	ひざ	名	膝盖；大腿
久し振り	ひさしぶり	名，形動	（隔了）好久
美術	びじゅつ	名	美术
非常	ひじょう	名，形動	非常；紧急；极、很
潜む	ひそむ	自五	隐藏；藏在（心里）
左	ひだり	名	左翼
引っかかる	ひっかかる	自五	挂住；牵连；上当；挂心
びっくり	びっくり	副，サ変	吃惊
日付	ひづけ	名	（记载文件等制成、提出的）年月日、日期
引っ越す	ひっこす	他五	搬家、迁居
ぴったり	ぴったり	副，形動	紧紧地；恰好、正合适；说中、猜中
引っ張る	ひっぱる	他五	（用力）拉、拽硬拉走
必要	ひつよう	名，形動	必要、必需、需要
人	ひと	名	人、人类；个人；成人；人品；他人；人手
酷い	ひどい	形	残酷、无情；厉害、严重
等しい	ひとしい	形	相等、相同；类似于、近似于
一つ	ひとつ	名，副	一个、一岁；表示强调；一体、一样；一方面；试一试、稍微；请
人手	ひとで	名	人工；旁人的手；人员、人手
一人，独り	ひとり	名，副	一个人；独身；独自；（后接否定）仅仅、只是
独りでに	ひとりでに	副	自然而然地、自动地
皮肉	ひにく	形動	挖苦、讽刺；不如意、不凑巧
捻くる	ひねくる	他五	玩弄、摆弄；找借口辩解；玩味
批判	ひはん	名，サ変	评论；批判
響く	ひびく	自五	发出回音、有回响；震动；影响；扬名、闻名
皮膚	ひふ	名	皮肤
暇	ひま	名，形動	时间；闲暇、闲工夫；休假；解雇；离婚
秘密	ひみつ	名	秘密
冷やかす	ひやかす	他五	挖苦、嘲弄、奚落；只问价不买
百	ひゃく	名	一百；许多；百岁
冷やす	ひやす	他五	凉一凉、（用冰）镇、使冷静
美容	びよう	名	美容
病院	びょういん	名	医院
病気	びょうき	名	病；老毛病、恶习
表現	ひょうげん	名，サ変	表现、表达
表情	ひょうじょう	名	表情；情况
評判	ひょうばん	名	评价、传闻；闻名、出名
開く	ひらく	自他五	开启、敞开；打开；（割る）（砕く）等词的避讳说法；（数学）开方；开始；开；开花；
昼	ひる	名	白天、白昼；中午、正午；午饭
広い	ひろい	形	辽阔；渊博的、广泛的；（心胸）宽广
拾う	ひろう	他五	拾、捡；挑、选；意外得到；在路上雇（汽车等）
広がる	ひろがる	自五	（面积、范围）扩大、蔓延；拡大、拡展
広げる	ひろげる	他下一	打开、展开；扩大、扩展
広場	ひろば	名	广场；（喻）场所
広まる	ひろまる	自五	传播、扩散
広める	ひろめる	他下一	扩大；普及、推广
便乗	びんじょう	名，サ変	就便搭乘（车船等）；趁机利用
貧乏	びんぼう	名，形動，サ変	贫穷、贫困
不安	ふあん	名，形動	不安、担心
封筒	ふうとう	名	信封
夫婦	ふうふ	名	夫妇
増える，殖える	ふえる	自下一	增加、增多
深い	ふかい	形	深；深刻、深远；深厚；（色、香）浓、深
付近	ふきん	名	附近
服	ふく	名	衣服
拭く	ふく	他五	擦、拭
吹く	ふく	自他五	刮；吹；吹（笛等）；吹牛；铸造
噴く	ふく	自五	（水蒸气等）喷出；（向外部）现出、冒出
複雑	ふくざつ	名，形動	复杂
含む	ふくむ	他五	含有；含着；怀有（想法、感情等）；带、含；包括
膨らむ	ふくらむ	自五	鼓起、膨胀；（想法、计划的规模）拡大
膨れる	ふくれる	自下一	肿、胀、鼓出；生气、不高兴
袋	ふくろ	名	口袋；水果的内皮
老ける	ふける	自下一	老、上年纪
塞がる	ふさがる	自五	塞满、占满；关、闭；占着、用着
塞ぐ	ふさぐ	自他五	挡、阻挡；（耳朵）堵、塞；郁闷、不舒畅
ふざける	ふざける	自下一	欢闹、欢蹦乱跳；开玩笑；愚弄、戏弄；（男女间）调情
無沙汰	ぶさた	名，サ変	久疏问候、久未通信
相応しい	ふさわしい	形	适合、相称
無事	ぶじ	名，形動	健康；平安、太平无事
不思議	ふしぎ	名，形動	不可思议、奇怪
不信	ふしん	名	不信任；没有信仰心；不守信用、不诚实
防ぐ	ふせぐ	他五	防御、防止、预防
伏せる	ふせる	他下一	翻（过来）、扣（过来）；向下、伏下；隐藏、埋伏、不张扬
不足	ふそく	名，形動	不足、缺少；不满意
蓋	ふた	名	盖子；揭晓
札	ふだ	名	牌子；条子；告示牌
豚	ぶた	名	猪
再び	ふたたび	副	再次
二つ	ふたつ	名	二、两个；第二；两岁
普段	ふだん	副	平常
不注意	ふちゅうい	名，形動	不注意、不小心
物価	ぶっか	名	物价
ぶつかる	ぶつかる	自五	撞、碰；遇到、碰到；适逢、赶到一起；交涉、直接谈判；冲突、争吵
筆	ふで	名	毛笔；写的字、画的画、笔迹
太い	ふとい	形	粗、胖、肥；（声音）粗；脸皮厚、厚颜无耻
懐	ふところ	名	怀、胸；被环抱的地方；腰包（身上）带的钱；心事、想法
太る，肥る	ふとる	自五	胖；增多
布団，蒲団	ふとん	名	蒲团、被褥、座垫的总称
船，舟	ふね	名	船；槽、盆
不便	ふべん	名，形動	不便、不方便
不満	ふまん	名，形動	不满、不满意
踏む	ふむ	他五	踏、踩；履行；经历过、经验过；评价、估价；押（韵）
不明	ふめい	名	不明、不详、不清楚；无能、见识少
麓	ふもと	名	山麓
冬	ふゆ	名	冬
ふらふら	ふらふら	副，形動，サ変	摇晃、晃荡；糊里糊涂；犹豫不定；累得东倒西歪的样子
ぶらぶら	ぶらぶら	副，サ変	晃荡、摇晃；溜达；赋闲、闲呆着
振り	ふり	名，接尾	样子、打扮；假装；陌生、不速（之客）；（舞蹈的）动作、姿势；抡（棒球的球棒、高尔
不利	ふり	名，形動	不利
降る	ふる	自五	（雨、雪等）下、降
振る	ふる	他五	挥、摇；撒；分配、分派、附上；拒绝；甩、抛弃、不参加；放弃、丢掉；开（汇票、支票
古い	ふるい	形	旧、老、不新鲜；陈旧、过时
振う，奮う	ふるう	自他五	挥动；发挥、显示
奮う	ふるう	自五	鼓起、振奋；积极、踊跃；兴旺、兴隆；奇特、新颖
震える	ふるえる	自下一	震动；发抖、哆嗦、颤抖
古里，故郷，故里，	ふるさと	名	故乡
振舞う	ふるまう	自他五	行动、动作；款待、请客
触れる	ふれる	自他下一	碰、触；（耳、目）感觉到；涉及、触及；抵触、违反；通知、告知
風呂	ふろ	名	浴室、洗澡水；浴池、澡堂
文化	ぶんか	名	文化
文章	ぶんしょう	名	文章
文明	ぶんめい	名	文明
分野	ぶんや	名	领域、范围、范畴
平気	へいき	名，形動	沉着、镇静；不在乎、无动于衷
平均	へいきん	名，サ変	平均；均衡、平衡
平行	へいこう	名，サ変	平行
平凡	へいぼん	名，形動	平凡
平和	へいわ	名，形動	和睦；和平
下手	へた	名，形動	拙劣、不擅长；不慎重、马虎
別に	べつに	副	特别（下接否定式）
蛇	へび	名	蛇
部屋	へや	名	房间；（相扑）师傅训练徒弟的地方；宫中仕女的房间
減らす	へらす	他五	减少
経る	へる	自下一	时间经过；通过（场所）；经历（过程）
減る	へる	自五	减少；（后接否定）畏怯；肚子饿
変	へん	名，形動	（突发的）事变；（音）将半音符号；异常；形迹可疑
便乗	べん	名，形動	方便；大小便、特指大便
勉強	べんきょう	名，サ変	学习；贱卖、便宜
返事	へんじ	名，サ変	回复、回信；答应、回答
便利	べんり	名，形動	方便
貿易	ぼうえき	名，サ変	贸易
方向	ほうこう	名	方向；方针
報告	ほうこく	名，サ変	报告；汇报
放送	ほうそう	名，サ変	广播、播放
報道	ほうどう	名，サ変	报道
方法	ほうほう	名	方法
訪問	ほうもん	名，サ変	访问
法律	ほうりつ	名	法律
吠える，吼える	ほえる	自下一	（狗、野兽）吠、吼；哭喊、叫嚷
外，他	ほか	名，助	其他地方或方位；其他人、事、物等；在……之外；只有
朗らか	ほがらか	形動	晴朗；舒畅、快活；（性格）开朗
僕	ぼく	代	（男子对晚辈或同辈的自称）我
誇り	ほこり	名	自豪、荣誉；自尊心
埃	ほこり	名	尘埃
誇る	ほこる	自五	自豪、夸耀
星	ほし	名	星星；斑点；星号；运势；得分；目标；嫌疑犯
欲しい	ほしい	形	希望得到；希望、要求
募集	ぼしゅう	名，サ変	招收、招募
保証	ほしょう	名，サ変	保证；担保
干す，乾す	ほす	他五	晒、晾、烤；把（水池等的）水放掉；喝干；不给工作
細い	ほそい	形	细、狭窄；（力量、数目等）少、微弱；饭量少；声音低而细
保存	ほぞん	名，サ変	保存
発作	ほっさ	名	发作
発足	ほっそく	名，サ変	开始活动；出发、动身
程	ほど	助词	……程度、左右；大致的数量；大致的场所；……越……；（后接否定表示）再也没有比…
殆ど	ほとんど	副，名	几乎；大概、大体上
炎	ほのお	名	火；强烈的情感
微笑む	ほほえむ	自五	微笑；（花）初放
褒める，誉める	ほめる	他下一	称赞
掘る	ほる	他五	挖、掘；挖出、发掘
彫る	ほる	他五	雕刻
惚れる	ほれる	自下一	迷恋；沉醉、信服；出神
滅びる，亡びる	ほろびる	自上一	灭亡；灭绝
滅ぼす	ほろぼす	他五	使灭亡；使破灭
本	ほん	名	书、书籍
本気	ほんき	名，形動	认真、正经
本当	ほんとう	名，形動	真正、真实；本来；的确、相当
本音	ほんね	名	原本的音色；真心话
本物	ほんもの	名	真货、真的东西
翻訳	ほんやく	名，サ変	（笔译的）翻译
毎	まい	接頭	每
参る	まいる	自五	（谦逊语）来、去；参拜；投降、折服；变弱、累垮；迷恋
舞う	まう	自五	舞蹈；飞舞
前	まえ	名	正前方；前面；正面；面前；以前、从前；在……之前；（顺序）前面；相当于、等于
任せる	まかせる	他下一	委托、托付；任凭、听由
賄う	まかなう	他五	供给（伙食等）；筹措、维持、处置
曲がる	まがる	自五	弯曲、倾斜；拐弯；（心眼、行为）不正
紛れる	まぎれる	自下一	混入；（由于忙碌等）忘记、（注意力）分散
巻く	まく	自他五	绕上，包上；围起；卷起；使打漩儿；拧、上（发条）；打卷儿
撒く	まく	他五	撒、散布；甩掉（跟踪者等）
蒔く，播く	まく	他五	播（种）
枕	まくら	名	枕头
負ける	まける	自他下一	输、败；屈服于、败愈；（对漆、药物等）过敏、起斑疹；让价、减价
曲げる	まげる	他下一	弯曲；歪曲；押当；放弃、改变
孫	まご	名	孙子；隔辈、间接
摩擦	まさつ	名，サ変	摩擦；不和睦、闹矛盾
正に	まさに	副	的确；马上、即将
勝る，優る	まさる	自五	优越、胜过
交える	まじえる	他下一	夹杂；交叉；交换；交
況して	まして	副	何况、况且
交じる，混じる，雑じる	まじる	他五	混、夹杂
交わる	まじわる	自五	交叉；交际
増す，益す	ます	自他五	增加、增多；加剧、更甚；增加
先ず	まず	副	最初；总之、姑且；大概
不味い	まずい	形	难吃的；笨拙；难看的、丑；不妙、不合适
貧しい	まずしい	形	贫穷；贫乏
交ぜる，混ぜる	まぜる	他下一	掺入；搅拌；加入
又	また	副，接続	别、其他；又、也；另外；（用于疑问句）究竟、到底；并且、同时；或者
未だ	まだ	副	还、尚；另外、更加；还算；才、不过
又は	または	接続	或是
街，町	まち	名	城镇；街道
間近	まぢか	形動	临近、逼近
間違い	まちがい	名	错误；差错、事故
間違う	まちがう	自他五	弄错
間違える	まちがえる	他下一	弄错、搞错
松	まつ	名	松（树）；新年装饰正门的松枝；新年期间（指元旦至正月七日）；用松、竹、梅排序时的
待つ	まつ	他五	等待；期待、指望
真っ直ぐ	まっすぐ	名，形動	笔直；照直；正直
全く	まったく　	副	完全；一点儿也（不）；实在
祭る	まつる	他五	祭祀；供奉
窓	まど	名	窗户
窓口	まどぐち	名	窗口；与外部联系的人、部门
纏まる	まとまる	自五	集中、归纳；统一、一致；解决、谈妥
纏める	まとめる	他下一	汇集、汇总；整理；解决、议定
学ぶ	まなぶ	他五	学习（技能等）；向某人学习
間に合う	まにあう	自五	赶上、来得及；够用、足够
免れる	まぬかれる	他下一	避免、摆脱
招く	まねく	他五	招呼；邀请；招致、引起
真似る	まねる	他下一	模仿、仿效
眩しい	まぶしい	形	晃眼；光彩夺目
まま	まま	名	原封不动、照旧；任由、随心所欲、任凭
豆	まめ	名	豆子；小型、微型
守り，護り	まもり	名	守卫；守护神；护身符
守る，護る	まもる	他五	保卫、守备；保守、保持；遵守
眉	まゆ	名	眉毛；眉黛
迷う	まよう	自五	迷失（方向）；困惑；迷恋、沉迷；（佛教用语）执迷、（死者）没能成佛
丸	まる	名，接頭	圆；打圈儿（表示正确）；全部；整、满；全部、整个儿
丸い，円い	まるい	形	圆形的、球形的；弯曲；圆滑、圆满
丸ごと	まるごと	副	整个儿、全部
回す，廻す	まわす	他五	旋转；围绕；（依次）传递；想尽办法；转、调职
回り	まわり	名，接尾	旋转；周围；巡回、巡访；蔓延、扩展；绕过、经过；圈数；（比较大小、容量的）圈
回る，廻る	まわる	自五	转、旋转；绕着、沿着；巡视；（依次）传递；绕弯；迂回；（在体内）发作；（动作等）
万一	まんいち	名，副	万一；倘若
満員	まんいん	名	客满、满座；挤满、载满
漫画	まんが	名	漫画
満足	まんぞく	名，サ変，形動	满足、满意；圆满、完美
満点	まんてん	名	满分；最好、绝佳
真中	まんなか	名	当中
実	み	名	果实；加在汤里的菜；内容
身	み	名	身体；自身；身份、处境；（动物等的）肉；地位；容器、盒体
見失う	みうしなう	他五	迷失、看不见
見栄	みえ	名	门面、外貌
見える	みえる	自下一	看得见；显出、显得；（敬）光临；看样子好象、似乎
見送る	みおくる	他五	送行；静观、等待下次（机会）
磨く，研く	みがく	他五	磨光；苦练、提高（修养）
味方	みかた	名，サ変	我方、同伙；帮着、袒护
右	みぎ	名	右；以上、前文；右倾；强的一方
見事	みごと	形動	精彩、出色；彻底
見込み	みこみ	名	希望、前途
見込む	みこむ	他五	期待、信赖；缠身；估计在内、计算在内
水	みず	名	水；洪水；（相扑）比赛暂停
湖	みずうみ	名	湖
自ら	みずから	名，副	自身；亲自
店	みせ	名	店
見せびらかす	みせびらかす	他五	炫耀、卖弄
見せる	みせる	他下一	出示、给看；呈现；装扮；让……看病；做给别人看（表示）决心和意志
味噌	みそ	名	豆酱；得意之处
溝	みぞ	名	水沟；槽、纹；隔阂
見出し	みだし	名	索引；标题
満たす	みたす	他五	填满；满足
乱す	みだす	他五	搅乱、弄乱；扰乱
乱れる	みだれる	自下一	混乱；不平静、不安定
道	みち	名	道路；路程；道理；方法；领域；过程
身近	みぢか	名，形動	身边；切身
導く	みちびく	他五	领进；指导；导致；得出（结论）
満ちる	みちる	自上一	充满；涨潮；满月；到期
見付かる	みつかる	自五	被发现；找到、看见
見付ける	みつける	他下一	看惯；找到
みっともない	みっともない	形	丑陋的、丢人的
見通す	みとおす	他五	看完；望得远；预测、看透
認める	みとめる	他下一	看到；判定、认为；承认；赏识
緑	みどり	名	绿；嫩芽；绿树
皆	みな	名	各位、全体；都、全
見なす	みなす	他五	看作、认为；（姑且）当作
港	みなと	名	港口
南	みなみ	名	南
醜い	みにくい	形	丑陋；（容颜）难看
見抜く	みぬく	他五	看穿、认清、识透
実り	みのり	名	结果实；收成；成绩、成果
身分	みぶん	名	处境；身份
見本	みほん	名	样本；典型、例子
見舞	みまい	名	探望、慰问（品）
見舞う	みまう	他五	探望；遭受（不幸等）
見守る	みまもる	他五	看守；紧盯；注视
耳	みみ	名	耳朵；听力；（面包、布、纸等的）边缘
身元，身許	みもと	名	来历、经历；身份
土産	みやげ	名	纪念品；礼物
都	みやこ	名	首都；具有某种特点的城市
見る	みる	他上一	看；判断；经历；吃亏、上当；观察；照料；试试看；一见；既然；一看
診る	みる	他上一	看病
皆	みんな	名，副	各位、都
向かう	むかう	自五	面向、朝着；对、向；往、去；趋向、接近；对抗、反抗
迎える	むかえる	他下一	迎接；（时期）来临、迎来；接、邀请；迎合
昔	むかし	名	从前；（已过去的）十来年时间
むかつく	むかつく	自五	反胃、恶心、要吐；升起、发怒
向き	むき	名	方向；核实；某一方面的人、人们
向く	むく	自五	向、朝；面向；合适；趋向
剥く	むく	他五	剥、削
報いる	むくいる	他上一	报答；报复、报仇
向ける	むける	他下一	朝、向；为了；派遣、打发；挪用、拨为、用于
向こう	むこう	名	那边、前方；目的地；对面、；另一边；今后、从现在起；对方
虫	むし	名	虫；热衷于某一事物、入迷的人；怒气、气愤、郁闷；小孩生病、发脾气闹人；对好哭、软
蒸す	むす	自他五	闷热；蒸
難しい	むずかしい	形	困难、难解决；繁琐；不高兴；好挑剔的、不易相处的
息子	むすこ	名	儿子；浪荡子
結ぶ	むすぶ	他五	系、连接、缔结；产生（结果）、凝结
娘	むすめ	名	女儿；姑娘
夢中	むちゅう	名	梦里；忘我、热衷于、着迷
胸	むね	名	胸、肺；心里、内心
村	むら	名	村、村庄；乡村
群がる	むらがる	自五	群聚、聚集
無理	むり	名，形動	不讲理、不合理；强干、硬干；不合适、有难度
無料	むりょう	名	免费、不要钱
目，眼	め	名，接尾	眼；视力；眼光、看法；经验；（形状、位置等）与眼相似；（网）眼、孔、格；第；相接
名刺	めいし	名	名片
命じる	めいじる	サ変	命令；任命；命名
名誉	めいよ	名，形動	名誉、荣誉、光荣；名誉称号
命令	めいれい	名，サ変	命令；任命；命名
迷惑	めいわく	名，形動，サ変	为难、打搅、麻烦
目上	めうえ	名	上司、上级、长辈
眼鏡	めがね	名	眼睛；眼力、判断力
恵まれる	めぐまれる	自下一	（蒙受）幸运、赋予、富有
目覚める	めざめる	自下一	睡醒、睁眼；觉悟、醒悟；认识到
飯	めし	名	米饭；用餐，食物；生活
召し上がる	めしあがる	他五	（敬）请吃、请喝
目下	めした	名	比自己地位低、年纪轻的人
珍しい	めずらしい	形	罕见；珍奇；新颖、新奇；珍贵
目立つ	めだつ	自五	显眼、显著；超群的
滅多	めった	形動	胡乱、鲁莽；几乎不、很少；（后接否定形式）轻易不、不常
目出度い	めでたい	形	可喜、可贺的；头脑简单、愚蠢的；很好；幸运、顺利
面倒	めんどう	名，形動	费事、麻烦；困难、棘手；照顾、照料
儲かる	もうかる	自五	得到、赚钱；得便宜、捡便宜
設ける	もうける	他下一	预备、准备；设立、建立、制定
申し上げる	もうしあげる	他下一	“说”的谦让语；“做”的谦让语
申し込む	もうしこむ	他五	提议、提出；预约；申请、报名
申し訳	もうしわけ	名	辩解、申辩；（只是形式上的）敷衍
申す	もうす	他五	（谦让语）说、讲、告诉、叫做
燃える	もえる	自下一	燃烧、着火；火红；热情洋溢
目的	もくてき	名	目标、意图
潜る	もぐる	自五	潜入水中；钻进、钻入；隐藏
若し	もし	副	如果、万一
文字	もじ	名	文字
齎す	もたらす	他五	带来；引起
餅	もち	名	年糕
用いる	もちいる	他上一	使用、采用、采纳；任用、录取
勿論	もちろん	副	理所当然
持つ	もつ	自他五	持、拿；携带；拥有；具有；怀有、抱有；承担；担负；支持、维持
勿体無い	もったいない	形	可惜、浪费；过分的；不胜惶恐
もっと	もっと	副	更、更加
最も	もっとも	副	最、顶
尤も	もっとも	形動，接	合乎情理、正确；虽然这么说
もてなす	もてなす	他五	应酬、接待、款待，招待
もどかしい	もどかしい	形	令人焦急、急不可待
戻す	もどす	他五	归还、退回；呕吐
基づく	もとづく	自五	基于、根据、按照；由于……而来
求める	もとめる	他下一	寻求、找；要求、征求；买、购买；想要、希望
元々	もともと	副	本来、原来；不赔不赚
元より	もとより	副	本来、当初、根本不用说、当然
戻る	もどる	自五	返回、折回；回到；退回、归还；恢复到原状态；回家
物	もの	名	物体、物品、东西；所有物、所持物；食物；质量、材料；反之任何事物、凡事；文章
物事	ものごと	名	事情、事物
揉む	もむ	他五	揉、搓、捻；按摩、推拿；争辩、争论
揉める	もめる	自下一	发生争执、起纠纷
燃やす	もやす	他五	燃烧、烧；情绪高涨、燃气、激起
催す	もよおす	他五	举办、主办、举行；感觉要
洩らす	もらす	他五	露处、洒；掉落；泄密、透露；流露、发泄；遗漏；逃逸
漏らす	もらす	他五	遗漏、漏掉；泄露、走漏
森	もり	名	森林、树林
盛る	もる	他五	盛满、堆起；盛、装入器皿；配药
漏れる	もれる	自下一	漏出、透出；走漏、泄露；被淘汰、被除外；流露、说出
脆い	もろい	形	脆、易坏的；脆弱；心软、易动感情的；没有耐力
問題	もんだい	名	问题；课题；引起争论的话题；麻烦、乱子；专题、题目
八百屋	やおや	名	蔬菜店；卖菜的人
喧しい	やかましい	形	吵闹、嘈杂；罗嗦，唠叨；严厉、严格；挑剔；议论纷纷
野球	やきゅう	名	棒球
焼く	やく	他五	燃烧、焚；加热、烧红；烤制；烤；日光浴、晒黑；印相片；妒忌
役所	やくしょ	名	政府机关、官厅
訳す	やくす	他五	翻译、译
約束	やくそく	名，サ変	商定、约定；约会；契约；规则；宿命；指望
役立つ	やくだつ	自五	起作用、有用、有效
焼ける	やける	自下一	燃烧、着火；烤制、烧成；晒、日光浴；变色；炽热；红霞；烧心
野菜	やさい	名	蔬菜、青菜
易しい	やさしい	形	容易、简单、易懂
優しい	やさしい	形	温柔、柔和；和蔼、娴淑；殷切
養う	やしなう	他五	抚养、养育；养活、供养；饲养；收养（子女）；养成；养生、培养
安い	やすい	形	便宜、低廉、贱
易い	やすい	形，接尾	容易、简单；易……、容易……
休み	やすみ	名	休息；睡觉；休假；缺席、缺勤、请假；中断
休む	やすむ	自他五	休息；睡觉；旷工、旷课、缺席、休假、请假；停歇、暂停
痩せる	やせる	自下一	消瘦；土地贫瘠
矢鱈	やたら	名，形動	任意、胡乱、过分
厄介	やっかい	名，形動	麻烦、难对付；照顾、照料、帮助
やっと	やっと	副	终于、好容易；勉强、好歹
矢張り	やはり	副	同样、也；依旧、依然；果然；毕竟还是、终归还是
破る	やぶる	他五	撕破、弄破；搞坏、破坏；违反；打破、突破；打败
敗れる	やぶれる	自下一	败北、失败
山	やま	名	山岳、小山；矿山；成堆、堆积如山；凸出的部分；成堆；最高峰、最高潮；押宝、投机
止む	やむ	自五	停止、结束；停、罢休
稍	やや	副	一点点、稍稍；不大工夫、一会儿；渐渐地
遣る	やる	他五	送、派去；挪至、放在；面向；进行；给与；发生、做；举办、上演；经营、从事；喝、吃
柔らかい	やわらかい	形	不硬的；柔软的；温和、平易的；轻松、通俗；融通的
和らげる	やわらげる	他下一	使柔和、使缓和；使文章等通俗易懂
湯	ゆ	名	热水；澡堂、浴室；温泉
夕方	ゆうがた	名	傍晚
友好	ゆうこう	名	友好
郵便	ゆうびん	名	邮政；邮件
有名	ゆうめい	形動	有名、著名、闻名
有利	ゆうり	形動	有利可图；有优势、有利
歪む	ゆがむ	自五	歪斜；行为不正、歪
歪める	ゆがめる	他下一	扭歪、歪曲
雪	ゆき	名	雪；洁白、雪白
行く	ゆく	自五	去、往；送到；经过、离开；上学；长大；进展；进行
輸出	ゆしゅつ	名，サ変	输出、出口
譲る	ゆずる	他五	转让；出让；谦让、尊让；让步；延期
豊か	ゆたか	形動	富裕；丰富；悠然；足够、十足
油断	ゆだん	名，サ変	疏忽、麻痹
ゆっくり	ゆっくり	副，サ変	慢慢；悠闲、充裕；迟迟；宽敞、舒服
茹でる	ゆでる	他下一	烫、煮、蒸
輸入	ゆにゅう	名，サ変	进口；引进
指	ゆび	名	手指、指头
指輪	ゆびわ	名	戒指
夢	ゆめ	名	梦、梦想；虚幻、渺茫；希望、思想；犹豫、迷茫
緩い	ゆるい	形	不紧、松弛；缓、不陡；不急、缓慢；不坚硬；不严厉
許す	ゆるす	他五	豁免、饶恕；允许、准许；条件允许、容许；接受；信赖、托付；放松、松弛；让、放；公
緩む	ゆるむ	自五	松懈；减缓；坡度缓的；解冻；松懈、缓和；行情跌价
緩める	ゆるめる	他下一	放松、松懈；放慢、减慢；坡度小；缓和、放宽
揺れる	ゆれる	自下一	摇晃、摇动；动荡；动摇
世	よ	名	世上、世间；人生；佛教中的过去、现在、未来三世；时势；时代
良い	よい	形	好、优秀；美丽；恰好、适当；有益；令人满意；完成、充分；幸运；方便、没关系；关系
酔う	よう	自五	喝醉；晕车或船等；陶醉、入神
用意	ようい	名，サ変	准备、预备；注意、警惕
要求	ようきゅう	名，サ変	要求、请求
ようこそ	ようこそ	感	欢迎、热烈欢迎
用事	ようじ	名	事、事情
様子	ようす	名	情况、情形；举止、态度；光景、征兆；缘故
要する	ようする	サ変	需要
要するに	ようするに	副	总而言之
要素	ようそ	名	成分、要素；因素
漸く	ようやく	副	总算、终于；渐渐地；好不容易、好歹
預金	よきん	名，サ変	存款
欲	よく	名	欲望、贪欲
よく	よく	副	充分、完全；做得好；太好了、真好；经常；居然、难为；竟敢
翌日	よくじつ	名	次日、第二天
余計	よけい	名，形動，副	多、更多；多余的；无用、白费；格外、越发
横	よこ	名	横、宽；横向；旁边；横线
横切る	よこぎる	自五	穿过、横穿
寄越す	よこす	他五	寄来、送过来；派人来
汚す	よごす	他五	弄脏；污染；贬低、侮辱
汚れる	よごれる	自下一	弄脏；污染；不干净、玷污
予算	よさん	名，サ変	预算；预定经费
予習	よしゅう	名，サ変	预习
止す	よす	他五	停止、作罢
寄せる	よせる	他下一	使靠近；集中；加；赠送；接近、逼近；依靠；访问、拜访；借口、托故；寄予、寄托
余所，他所	よそ	名	别处；旁边；别人；无视、弃置不顾
予想	よそう	名，サ変	预计、预测；预料
予定	よてい	名，サ変	预定、计划
夜中	よなか	名	半夜、夜半
世の中	よのなか	名	世上、社会；人生；时势、时代
呼ぶ	よぶ	他五	呼喊；叫来；邀请；称呼、叫；引起；招致
余程	よほど	副	相当；差一点就、几乎要……
蘇る	よみがえる	自五	复苏、复活；恢复
読む	よむ	他五	读、念、诵；阅读、理解；解毒；了解；观察、揣摩；点数；考虑棋的着数
より	より	格助，副	出发点、起点；时间的起点；比较的基准；以外；更加；由于
依る，拠る，因る	よる	自五	按照；依据；缘于、因为；依靠、凭借；表示行为者
寄る	よる	自五	接近；偏向；聚集；顺路到；重叠、增多；依靠、凭借
夜	よる	名	夜间、晚上
喜び	よろこび	名	欢喜、高兴；喜事、喜庆事；道喜、贺喜
喜ぶ	よろこぶ	他五	高兴、欢喜；欣然接受
宜しい	よろしい	形	方便、适宜；好
宜しく	よろしく	副	好好地、适当地；请问好、请致意；请关照；活象
輿論	よろん	名	舆论、公论
弱い	よわい	形	软弱、虚弱；脆弱、易坏的；微弱；不擅长、经不住
弱める	よわめる	自下一	使衰弱；使变弱；减弱、拧小
弱る	よわる	自五	衰弱；困窘、为难、尴尬
来月	らいげつ	名	下个月
来週	らいしゅう	名	下周
来年	らいねん	名	来年、明年
楽	らく	名，形動	舒服、舒适、快乐；富裕；容易、轻松
楽観	らっかん	名，サ変	乐观
利益	りえき	名	赚头、利润；益处、利益
理科	りか	名	理科
理解	りかい	名，サ変	了解、理解；体谅、谅解
利口	りこう	名，形動	聪明；能说会道；周到、圆满
理想	りそう	名	理想
立派	りっぱ	形動	优秀、出色；崇高、（仪表）堂堂；正派、充足；漂亮、美观；伟大、了不起
理由	りゆう	名	根据、理由
留学	りゅうがく	名，サ変	留学
流行	りゅうこう	名，サ変	流行、时尚、时髦；疾病流行
寮	りょう	名	宿舍
利用	りよう	名，サ変	利用
両替	りょうがえ	名，サ変	兑、兑换
料金	りょうきん	名	费用、手续费
両親	りょうしん	名	双亲
両方	りょうほう	名	两边、两侧；双方
料理	りょうり	名，サ変	菜肴；处理
旅行	りょこう	名，サ変	旅行
履歴書	りれきしょ	名	履历书
理論	りろん	名	理论
留守	るす	名，サ変	不在家；疏忽、忽略
留守番	るすばん	名	看家、看门
礼	れい	名	礼仪；致礼；感谢；谢礼；返礼
例	れい	名	前例、先例；常例、惯例；与往常一样；例子、事例；知彼此知道的人或事
例外	れいがい	名	例外
礼儀	れいぎ	名	礼仪
歴史	れきし	名	历史；史学
列車	れっしゃ	名	列车
練習	れんしゅう	名，サ変	练习
連続	れんぞく	名，サ変	连续
連絡	れんらく	名，サ変	联络；接连；通知、告诉
廊下	ろうか	名	走廊、廊子
老人	ろうじん	名	老人
労働	ろうどう	名，サ変	劳动
浪人	ろうにん	名	失去主人的流浪武士；失业者、考不上大学、找不到工作的毕业生
録音	ろくおん	名，サ変	录音
碌に	ろくに	副	满意、充分、很好
論じる	ろんじる	他上一	论述、阐述；争论、辩论
輪	わ	名	圈、环；车轮；箍
若い	わかい	形	年轻；有活力的；幼稚、未成熟；（数字、号码）小
沸かす	わかす	他五	烧开、烧热、加热；使情绪高涨
我が儘	わがまま	名，形動	任性放私、恣意
若者	わかもの	名	年轻人、青年
分かる，判る	わかる	自五	理解、洞察；明白、发现；知道、认知、判断；判明；懂事
分かれる	わかれる	自下一	分歧；分开、分裂；区分；解散
別れる	わかれる	自下一	分别、分离；离婚
沸く	わく	自五	煮开、烧热；激动、兴奋；熔化；哄闹、叫嚷
湧く	わく	自五	涌出、冒出；发生、孽生；突然出现、涌起；产生
枠	わく	名	框、框子；边线、轮廓；界限、范围
訳	わけ	名	意思；道理；理由；事由；当然；费事、麻烦；否定、断定的委婉说法；（用否定式表示）
分ける	わける	他下一	分割、划分；分离、分开；分别、区别；分配；分让；拨开、置之不理；辨明是非
わざと	わざと	副	故意
災い	わざわい	名，サ変	灾难、不幸
わざわざ	わざわざ	副	特别、特意；故意
僅か	わずか	副，形動	仅、一点点；稍微、微小；仅仅；好不容易、勉强
煩う，患う	わずらう	自他五	烦心、苦恼；患病、生病
忘れ物	わすれもの	名	遗忘的东西、遗失的东西
忘れる	わすれる	自他下一	忘记；没注意；遗落、丢下；忘却、忘怀
綿	わた	名	棉花
話題	わだい	名	话题
私	わたくし	名，代	自己、我；私人
私	わたし	代	我
渡す	わたす	他五	架、跨越；渡河；交、递；给；让给
渡る	わたる	自五	过河、过；渡；吹过、掠过；度日、过活；交给、归谁所有；分发到
侘しい	わびしい	形	寂寞；冷清、清静；贫困、寒酸
詫びる	わびる	自他下一	道歉、赔不是
和服	わふく	名	和服
笑い	わらい	名	笑、微笑；嘲弄、嘲笑
笑う	わらう	自他五	笑、微笑；嘲讽；花开、开绽
割	わり	名	比例；百分比；比较、比；兑水、加水；分派
割合	わりあい	名，副	比率、比例；百分比；比较
割に	わりに	副	意外、格外；比较
割引	わりびき	名，サ変	减价、打折；贴现票据；（听话）打折扣
割る	わる	自他五	破坏；分、切、割；弄破；挤进、拨开；分配；除；分裂、离间；介入；低于、少于；对、
悪い	わるい	形	坏、不好、恶；错误、不对；恶劣、不利；不正常的；不愉快、不舒畅；有害、不利；身体
割れる	われる	自下一	碎、坏了；裂开；整除；分裂；暴露、败露；声音难听、刺耳
我々	われわれ	代	我们
腕力	わんりょく	名	腕力、臂力；体力；暴力、动武
